"73.151.138.252","28635","36.63.70.216","80","23","34592","0","0","23","34592","0.000005000","0.0035","N/A","78662876.63"
"71.215.84.77","47503","181.175.235.132","80","68","96404","0","0","68","96404","0.000011000","0.0006","N/A","1343609756.10"
"141.147.142.213","4858","232.60.178.117","80","2","2968","0","0","2","2968","0.000014000","0.0000","N/A","1484000000.00"
"133.45.240.235","51232","211.231.171.101","80","2","112","2","112","0","0","0.000019000","0.0011","846081.21","N/A"
"130.91.77.192","58300","211.231.164.53","80","3","168","3","168","0","0","0.000032000","0.0020","684317.72","N/A"
"41.83.172.63","23083","73.97.71.233","80","1","64","0","0","1","64","0.000034000","0.0000","N/A","N/A"
"154.110.10.253","23891","71.85.125.213","80","2","112","2","112","0","0","0.000037000","0.0100","89180.85","N/A"
"219.126.173.146","53887","58.57.201.104","80","1","56","1","56","0","0","0.000037000","0.0000","N/A","N/A"
"0.217.206.147","52284","219.1.170.180","45581","3","168","0","0","3","168","0.000043000","0.0000","N/A","N/A"
"142.84.193.204","19127","232.60.178.111","443","2","1066","0","0","2","1066","0.000049000","0.0158","N/A","541048.09"
"181.175.234.65","63673","199.174.53.50","80","2","573","2","573","0","0","0.000059000","0.0144","319220.06","N/A"
"95.165.42.218","49876","71.85.125.213","80","2","1582","2","1582","0","0","0.000063000","0.0000","6328000000.00","N/A"
"92.249.0.98","50017","218.37.69.220","443","4","6016","0","0","4","6016","0.000072000","0.0366","N/A","1314936.75"
"80.49.215.26","45748","73.168.180.142","80","5","250","0","0","5","250","0.000073000","0.0214","N/A","93409.93"
"231.120.155.24","54344","92.71.197.151","1935","7","5777","0","0","7","5777","0.000073000","0.0352","N/A","1313439.62"
"83.91.98.74","53306","211.231.161.79","8081","18","1152","18","1152","0","0","0.000082000","0.0125","737103.10","N/A"
"156.178.53.138","1833","232.60.179.123","80","36","54144","0","0","36","54144","0.000094000","0.0336","N/A","12883759.67"
"137.230.161.31","55147","181.0.154.85","465","9","414","9","414","0","0","0.000098000","0.0345","96066.83","N/A"
"36.99.180.91","49159","92.52.238.178","443","1","46","1","46","0","0","0.000098000","0.0000","N/A","N/A"
"43.206.69.106","3451","211.231.170.42","80","11","506","11","506","0","0","0.000104000","0.0064","634582.22","N/A"
"138.154.165.228","49329","180.238.47.116","443","2","2928","0","0","2","2928","0.000129000","0.0191","N/A","1223249.26"
"138.24.100.25","43738","73.151.139.181","443","3","173","3","173","0","0","0.000130000","0.0061","225664.44","N/A"
"43.249.222.188","63853","211.231.171.101","80","5","280","5","280","0","0","0.000138000","0.0011","2003577.82","N/A"
"76.74.129.251","16954","71.231.207.64","80","2","92","2","92","0","0","0.000152000","0.0102","71867.98","N/A"
"36.225.47.154","8080","83.159.91.154","1214","2","92","0","0","2","92","0.000157000","0.0264","N/A","27929.57"
"14.17.144.76","51635","153.231.134.73","80","4","5576","0","0","4","5576","0.000165000","0.0007","N/A","64649275.36"
"142.73.39.14","10695","232.60.179.146","80","3","4332","0","0","3","4332","0.000193000","0.0000","N/A","1444000000.00"
"130.110.214.216","4537","74.116.201.200","80","2","92","2","92","0","0","0.000195000","0.0043","171202.61","N/A"
"138.154.165.228","49267","180.238.47.116","443","3","4392","0","0","3","4392","0.000195000","0.0000","N/A","11712000000.00"
"191.235.251.179","34698","73.168.180.142","80","4","5320","0","0","4","5320","0.000203000","0.0000","N/A","3869090909.09"
"218.204.36.184","50710","36.225.197.138","80","24","1344","24","1344","0","0","0.000214000","0.0369","291058.72","N/A"
"130.17.195.201","62459","211.231.161.79","8081","12","768","12","768","0","0","0.000229000","0.0046","1326711.29","N/A"
"232.56.227.14","50599","58.57.179.213","80","1","56","0","0","1","56","0.000245000","0.0000","N/A","N/A"
"43.173.249.203","54208","148.163.60.134","80","3","138","3","138","0","0","0.000248000","0.0001","16727272.73","N/A"
"132.176.34.155","4437","73.42.94.163","25","1","58","1","58","0","0","0.000249000","0.0000","N/A","N/A"
"232.65.98.190","54858","138.82.153.231","80","16","24064","0","0","16","24064","0.000266000","0.0002","N/A","1024000000.00"
"229.127.219.213","40019","50.19.161.245","8080","2","112","2","112","0","0","0.000280000","0.0000","896000000.00","N/A"
"4.3.1.21","49864","73.187.41.247","80","23","33212","0","0","23","33212","0.000285000","0.0013","N/A","200980332.83"
"140.192.202.69","60111","211.231.170.42","80","14","644","14","644","0","0","0.000291000","0.0018","2886274.51","N/A"
"218.57.166.66","38133","211.231.170.221","80","5","230","5","230","0","0","0.000292000","0.0260","70864.63","N/A"
"71.215.84.77","47743","181.175.235.132","80","1","56","0","0","1","56","0.000294000","0.0000","N/A","N/A"
"129.127.234.24","53696","211.231.171.101","80","25","1150","25","1150","0","0","0.000300000","0.0190","485001.85","N/A"
"142.91.116.28","3949","36.3.67.168","80","1","1496","0","0","1","1496","0.000307000","0.0000","N/A","N/A"
"209.2.245.104","61541","211.231.175.252","80","10","500","10","500","0","0","0.000308000","0.0077","520359.05","N/A"
"80.96.48.125","57620","39.110.196.167","18405","1","83","1","83","0","0","0.000311000","0.0000","N/A","N/A"
"36.102.120.130","52380","92.52.238.180","443","1","81","1","81","0","0","0.000319000","0.0000","N/A","N/A"
"92.15.216.36","54052","92.186.73.117","80","1","50","0","0","1","50","0.000326000","0.0000","N/A","N/A"
"196.58.33.201","55700","211.231.164.210","8182","1","50","1","50","0","0","0.000337000","0.0000","N/A","N/A"
"56.215.128.144","42551","211.188.20.194","443","1","56","0","0","1","56","0.000346000","0.0000","N/A","N/A"
"180.134.171.240","51006","95.39.84.122","42047","1","56","0","0","1","56","0.000354000","0.0000","N/A","N/A"
"142.83.94.188","24032","232.60.178.73","80","4","5776","0","0","4","5776","0.000368000","0.0047","N/A","9816868.49"
"131.240.239.150","14357","232.60.178.235","443","3","3192","0","0","3","3192","0.000371000","0.0056","N/A","4532481.36"
"83.116.167.132","50027","176.205.174.33","80","1","56","1","56","0","0","0.000397000","0.0000","N/A","N/A"
"135.240.251.133","53847","211.231.169.226","80","8","368","8","368","0","0","0.000450000","0.0150","196725.69","N/A"
"43.30.154.181","58366","58.57.200.97","443","1","56","1","56","0","0","0.000457000","0.0000","N/A","N/A"
"39.109.242.114","22756","181.175.224.85","443","1","56","0","0","1","56","0.000464000","0.0000","N/A","N/A"
"71.215.84.15","49534","181.175.235.118","80","1","56","0","0","1","56","0.000472000","0.0000","N/A","N/A"
"142.83.185.132","22293","232.60.178.255","80","4","5277","0","0","4","5277","0.000475000","0.0127","N/A","3324879.89"
"71.212.187.123","13922","148.168.208.100","80","4","224","4","224","0","0","0.000479000","0.0043","421547.87","N/A"
"140.198.185.111","51727","211.231.171.74","182","14","896","14","896","0","0","0.000483000","0.0253","283746.34","N/A"
"141.67.215.124","43846","232.60.178.212","443","2","3008","0","0","2","3008","0.000498000","0.0000","N/A","2187636363.64"
"131.243.107.108","14017","232.60.178.229","80","1","50","0","0","1","50","0.000499000","0.0000","N/A","N/A"
"140.254.94.21","50379","211.231.169.234","80","5","230","5","230","0","0","0.000521000","0.0010","1774349.08","N/A"
"71.126.3.209","49030","181.175.231.233","443","1","452","0","0","1","452","0.000569000","0.0000","N/A","N/A"
"176.210.78.154","47505","176.218.155.149","80","1","255","0","0","1","255","0.000579000","0.0000","N/A","N/A"
"181.169.202.140","41376","215.74.24.68","80","11","16544","0","0","11","16544","0.000590000","0.0007","N/A","180808743.17"
"90.31.149.234","4566","211.231.175.116","80","2","112","2","112","0","0","0.000596000","0.0285","31434.18","N/A"
"129.198.41.197","49628","181.168.161.170","8080","2","92","2","92","0","0","0.000596000","0.0000","736000000.00","N/A"
"140.215.110.134","3618","211.231.170.42","80","2","92","2","92","0","0","0.000597000","0.0010","762694.30","N/A"
"95.212.162.26","53737","211.231.175.252","80","8","448","8","448","0","0","0.000600000","0.0365","98275.25","N/A"
"131.242.234.95","25871","232.60.179.232","443","1","326","0","0","1","326","0.000602000","0.0000","N/A","N/A"
"180.229.25.88","53621","73.177.182.33","80","1","46","0","0","1","46","0.000629000","0.0000","N/A","N/A"
"232.23.227.21","38159","232.31.16.186","9050","1","100","0","0","1","100","0.000633000","0.0000","N/A","N/A"
"140.246.80.234","56645","36.225.92.93","443","5","1581","5","1581","0","0","0.000658000","0.0336","376115.14","N/A"
"43.173.249.74","40097","71.231.207.117","80","1","64","1","64","0","0","0.000659000","0.0000","N/A","N/A"
"181.157.152.20","40283","37.20.48.200","80","3","150","3","150","0","0","0.000664000","0.0198","60572.41","N/A"
"58.12.54.205","55409","75.179.100.152","80","25","34077","0","0","25","34077","0.000669000","0.0010","N/A","267008814.89"
"83.96.218.7","23365","211.231.170.42","80","5","230","5","230","0","0","0.000677000","0.0012","1582115.22","N/A"
"138.25.191.167","1136","73.151.139.186","80","1","464","1","464","0","0","0.000681000","0.0000","N/A","N/A"
"71.248.27.151","38486","191.235.251.124","80","1","504","1","504","0","0","0.000684000","0.0000","N/A","N/A"
"132.189.13.239","59570","211.231.171.101","80","7","322","7","322","0","0","0.000711000","0.0359","71744.88","N/A"
"177.96.185.250","17785","43.245.12.32","1176","1","68","0","0","1","68","0.000718000","0.0000","N/A","N/A"
"130.91.79.9","53759","211.231.164.165","8182","4","184","4","184","0","0","0.000722000","0.0296","49746.54","N/A"
"141.146.2.212","56100","232.60.179.253","443","2","239","0","0","2","239","0.000732000","0.0003","N/A","6128205.13"
"231.13.229.108","38507","231.8.95.83","31680","1","56","0","0","1","56","0.000747000","0.0000","N/A","N/A"
"43.173.249.129","65516","191.126.9.10","80","3","138","3","138","0","0","0.000751000","0.0225","49016.56","N/A"
"153.248.144.209","1569","58.57.200.105","80","1","46","1","46","0","0","0.000768000","0.0000","N/A","N/A"
"143.145.64.205","50730","181.168.221.165","8080","5","280","5","280","0","0","0.000768000","0.0174","128403.55","N/A"
"89.131.91.242","4395","70.7.191.81","80","21","966","21","966","0","0","0.000773000","0.0178","434890.26","N/A"
"76.175.191.101","61749","176.205.174.34","80","2","92","2","92","0","0","0.000823000","0.0000","40888888.89","N/A"
"182.111.118.144","3630","92.52.238.178","80","1","81","1","81","0","0","0.000830000","0.0000","N/A","N/A"
"231.222.212.26","52230","232.60.176.31","80","13","19552","0","0","13","19552","0.000839000","0.0044","N/A","35476525.29"
"71.215.84.96","50601","181.175.235.117","80","12","17125","0","0","12","17125","0.000841000","0.0001","N/A","1245454545.45"
"43.173.249.66","38212","36.225.53.207","80","2","379","2","379","0","0","0.000842000","0.0001","60640000.00","N/A"
"133.32.223.148","56439","0.216.32.154","16570","1","56","1","56","0","0","0.000851000","0.0000","N/A","N/A"
"219.215.237.124","49945","211.231.164.53","80","8","368","8","368","0","0","0.000860000","0.0011","2708371.67","N/A"
"137.88.228.141","52485","181.168.191.2","8080","4","224","4","224","0","0","0.000872000","0.0200","89510.49","N/A"
"78.254.52.112","57684","232.60.178.228","443","4","5984","0","0","4","5984","0.000881000","0.0076","N/A","6290670.17"
"82.147.246.228","63056","177.207.6.213","3389","3","287","3","287","0","0","0.000882000","0.0000","574000000.00","N/A"
"222.142.247.59","49476","186.237.209.221","80","1","1351","0","0","1","1351","0.000883000","0.0000","N/A","N/A"
"216.9.124.132","56304","73.151.139.236","80","1","1225","1","1225","0","0","0.000895000","0.0000","N/A","N/A"
"58.57.179.187","38273","181.175.240.11","80","1","903","1","903","0","0","0.000898000","0.0000","N/A","N/A"
"131.242.255.236","11788","232.60.179.136","80","5","7342","0","0","5","7342","0.000906000","0.0005","N/A","122366666.67"
"56.159.190.228","50876","50.47.118.168","21888","6","604","6","604","0","0","0.000925000","0.0320","150787.95","N/A"
"43.239.208.218","62176","81.230.240.113","57042","1","249","1","249","0","0","0.000938000","0.0000","N/A","N/A"
"232.60.177.144","54107","29.22.12.229","80","1","64","1","64","0","0","0.000943000","0.0000","N/A","N/A"
"219.184.218.177","63352","211.231.171.101","80","7","322","7","322","0","0","0.000943000","0.0159","161788.72","N/A"
"128.112.224.116","58603","211.231.170.42","80","6","276","6","276","0","0","0.000957000","0.0042","525339.04","N/A"
"138.25.191.167","1138","73.151.139.186","80","1","466","1","466","0","0","0.000959000","0.0000","N/A","N/A"
"218.204.44.217","52639","36.225.173.101","8080","2","92","2","92","0","0","0.000979000","0.0050","146089.72","N/A"
"151.238.213.18","49382","50.19.161.202","8080","4","224","4","224","0","0","0.000990000","0.0360","49817.91","N/A"
"43.252.62.144","55185","71.126.4.64","990","1","46","1","46","0","0","0.001004000","0.0000","N/A","N/A"
"95.165.229.246","8502","232.27.52.85","443","1","46","1","46","0","0","0.001056000","0.0000","N/A","N/A"
"211.231.161.79","8081","94.242.183.202","2267","6","384","0","0","6","384","0.001058000","0.0138","N/A","222867.09"
"181.131.204.244","61094","186.237.209.199","80","8","12032","0","0","8","12032","0.001092000","0.0148","N/A","6488002.16"
"150.212.64.210","52226","176.205.174.34","80","1","56","1","56","0","0","0.001100000","0.0000","N/A","N/A"
"71.126.2.138","11376","181.175.237.237","80","1","64","0","0","1","64","0.001102000","0.0000","N/A","N/A"
"140.193.130.196","49744","211.231.164.53","80","8","368","8","368","0","0","0.001115000","0.0125","235012.37","N/A"
"137.167.234.154","40700","211.231.164.53","80","6","336","6","336","0","0","0.001126000","0.0073","367614.88","N/A"
"36.3.67.176","57473","71.215.84.24","80","1","56","1","56","0","0","0.001131000","0.0000","N/A","N/A"
"74.110.251.233","43365","181.175.233.23","80","1","56","0","0","1","56","0.001146000","0.0000","N/A","N/A"
"41.35.141.10","59226","92.43.182.34","22","1","46","1","46","0","0","0.001146000","0.0000","N/A","N/A"
"138.29.74.25","10581","176.205.174.33","80","1","46","1","46","0","0","0.001176000","0.0000","N/A","N/A"
"50.46.225.125","50127","36.3.67.213","443","1","81","0","0","1","81","0.001179000","0.0000","N/A","N/A"
"148.57.228.42","34995","223.146.109.201","80","1","56","0","0","1","56","0.001179000","0.0000","N/A","N/A"
"71.126.3.230","65470","181.175.235.116","80","10","13376","0","0","10","13376","0.001187000","0.0001","N/A","1304975609.76"
"77.109.38.186","55404","211.231.171.101","80","2","92","2","92","0","0","0.001192000","0.0360","20447.85","N/A"
"133.203.14.171","33712","75.179.35.253","80","4","184","4","184","0","0","0.001200000","0.0002","8177777.78","N/A"
"77.140.205.223","53253","181.6.159.83","1975","1","56","1","56","0","0","0.001207000","0.0000","N/A","N/A"
"77.92.229.60","49988","148.163.8.197","8080","10","460","10","460","0","0","0.001207000","0.0252","146141.93","N/A"
"143.167.235.149","59204","75.199.13.163","34474","1","46","1","46","0","0","0.001255000","0.0000","N/A","N/A"
"187.72.79.82","2928","179.129.249.217","25","1","52","1","52","0","0","0.001256000","0.0000","N/A","N/A"
"36.217.97.22","1598","75.179.73.162","80","1","56","1","56","0","0","0.001258000","0.0000","N/A","N/A"
"140.223.8.144","58547","211.200.228.231","80","1","56","1","56","0","0","0.001270000","0.0000","N/A","N/A"
"78.217.254.106","49206","232.60.178.247","443","2","1066","0","0","2","1066","0.001286000","0.0001","N/A","70479338.84"
"211.231.161.79","8081","140.218.32.255","1880","1","46","0","0","1","46","0.001306000","0.0000","N/A","N/A"
"131.245.38.203","19250","232.60.178.235","80","2","2888","0","0","2","2888","0.001308000","0.0052","N/A","4455930.57"
"142.89.186.164","10311","232.60.178.65","443","3","4332","0","0","3","4332","0.001310000","0.0000","N/A","1386240000.00"
"95.157.106.198","55075","211.231.170.237","80","6","336","6","336","0","0","0.001318000","0.0261","102933.29","N/A"
"131.246.142.199","3896","232.60.178.116","80","4","5984","0","0","4","5984","0.001324000","0.0050","N/A","9645778.76"
"187.232.165.251","3342","73.151.139.77","554","1","46","1","46","0","0","0.001326000","0.0000","N/A","N/A"
"216.42.62.106","53252","71.126.3.219","80","4","224","4","224","0","0","0.001353000","0.0001","18474226.80","N/A"
"131.245.73.192","57982","232.60.179.246","80","2","2992","0","0","2","2992","0.001357000","0.0011","N/A","22731244.06"
"146.24.207.2","55141","150.16.26.245","8921","1","56","0","0","1","56","0.001359000","0.0000","N/A","N/A"
"148.161.198.130","54471","73.168.177.160","80","1","50","0","0","1","50","0.001374000","0.0000","N/A","N/A"
"179.23.112.124","40830","71.71.101.138","443","3","173","0","0","3","173","0.001387000","0.0311","N/A","44475.87"
"140.250.236.198","61880","211.231.161.79","8081","10","460","10","460","0","0","0.001388000","0.0242","152128.98","N/A"
"49.113.206.248","20554","73.151.139.180","443","1","56","1","56","0","0","0.001395000","0.0000","N/A","N/A"
"219.222.85.40","51108","211.231.169.226","80","8","368","8","368","0","0","0.001398000","0.0357","82368.08","N/A"
"131.240.241.137","12399","232.60.178.101","443","2","2888","0","0","2","2888","0.001448000","0.0000","N/A","1925333333.33"
"25.95.176.153","51231","211.231.175.138","80","1","46","1","46","0","0","0.001450000","0.0000","N/A","N/A"
"143.167.71.105","59169","176.205.174.34","80","1","46","1","46","0","0","0.001450000","0.0000","N/A","N/A"
"181.168.230.74","8080","88.196.115.209","1650","1","46","0","0","1","46","0.001452000","0.0000","N/A","N/A"
"253.105.137.173","59925","176.205.189.76","80","2","553","2","553","0","0","0.001462000","0.0001","65058823.53","N/A"
"222.7.164.6","61758","58.57.201.151","80","3","168","3","168","0","0","0.001463000","0.0000","28595744.68","N/A"
"133.203.23.208","33701","58.57.201.246","80","2","112","2","112","0","0","0.001464000","0.0001","7724137.93","N/A"
"80.112.254.88","45949","50.56.75.82","80","2","92","2","92","0","0","0.001477000","0.0042","175238.10","N/A"
"143.145.82.17","58596","80.101.12.230","6881","1","46","1","46","0","0","0.001505000","0.0000","N/A","N/A"
"211.231.161.79","8081","95.233.171.172","1091","2","92","0","0","2","92","0.001510000","0.0120","N/A","61170.21"
"218.37.65.188","51971","148.168.217.153","80","1","56","1","56","0","0","0.001525000","0.0000","N/A","N/A"
"209.3.16.146","3404","211.231.164.53","80","1","50","1","50","0","0","0.001527000","0.0000","N/A","N/A"
"142.231.50.54","28422","181.168.162.26","80","1","46","1","46","0","0","0.001540000","0.0000","N/A","N/A"
"142.89.36.0","11954","36.3.67.182","80","3","4332","0","0","3","4332","0.001542000","0.0000","N/A","1506782608.70"
"229.126.30.172","50151","181.168.230.74","8080","3","138","3","138","0","0","0.001554000","0.0277","39867.11","N/A"
"232.31.17.255","52995","71.126.3.119","80","1","745","1","745","0","0","0.001566000","0.0000","N/A","N/A"
"71.126.4.235","23663","181.175.230.104","80","2","112","0","0","2","112","0.001567000","0.0000","N/A","44800000.00"
"142.81.138.239","25980","232.60.177.164","443","2","2888","0","0","2","2888","0.001584000","0.0000","N/A","1777230769.23"
"43.173.249.193","52318","189.129.142.66","80","4","184","4","184","0","0","0.001589000","0.0005","2852713.18","N/A"
"131.169.229.20","63390","181.168.161.170","80","22","1012","22","1012","0","0","0.001591000","0.0126","642590.68","N/A"
"58.57.100.133","63003","243.98.113.125","80","3","3908","0","0","3","3908","0.001615000","0.0002","N/A","186095238.10"
"91.228.222.21","49809","211.231.169.234","80","4","184","4","184","0","0","0.001624000","0.0039","373225.15","N/A"
"58.57.201.143","36378","181.175.235.116","80","62","86122","0","0","62","86122","0.001667000","0.0006","N/A","1202401396.16"
"95.158.13.170","1450","211.231.161.181","80","2","112","2","112","0","0","0.001668000","0.0311","28835.32","N/A"
"229.134.227.35","3359","176.205.189.53","80","1","46","1","46","0","0","0.001671000","0.0000","N/A","N/A"
"135.213.82.153","55213","36.86.220.211","80","2","389","2","389","0","0","0.001704000","0.0041","755339.81","N/A"
"140.214.129.137","52979","176.205.141.126","80","1","642","1","642","0","0","0.001711000","0.0000","N/A","N/A"
"229.224.35.45","63138","159.183.111.121","80","1","46","1","46","0","0","0.001729000","0.0000","N/A","N/A"
"181.112.106.96","36486","181.175.237.236","443","1","56","0","0","1","56","0.001733000","0.0000","N/A","N/A"
"141.148.31.86","15596","176.205.174.33","80","1","46","1","46","0","0","0.001747000","0.0000","N/A","N/A"
"49.119.154.86","54092","50.173.93.146","6890","7","392","7","392","0","0","0.001748000","0.0211","148288.25","N/A"
"140.217.153.190","57804","211.231.164.53","80","7","392","7","392","0","0","0.001761000","0.0001","25917355.37","N/A"
"77.121.3.68","54058","36.86.42.68","15203","1","62","1","62","0","0","0.001769000","0.0000","N/A","N/A"
"177.240.107.165","39836","211.188.252.116","80","1","64","0","0","1","64","0.001775000","0.0000","N/A","N/A"
"12.191.72.38","21784","211.231.164.202","8182","1","46","1","46","0","0","0.001777000","0.0000","N/A","N/A"
"41.35.141.10","48101","92.47.213.204","22","2","92","2","92","0","0","0.001787000","0.0000","N/A","N/A"
"181.9.99.81","49295","181.175.235.133","80","6","7641","0","0","6","7641","0.001812000","0.0000","N/A","2183142857.14"
"140.240.221.217","52864","211.231.170.42","80","1","46","1","46","0","0","0.001829000","0.0000","N/A","N/A"
"231.178.129.107","10633","50.0.117.105","443","2","1876","2","1876","0","0","0.001829000","0.0005","27436928.70","N/A"
"135.184.243.43","2374","211.231.169.226","80","4","184","4","184","0","0","0.001848000","0.0074","200163.18","N/A"
"49.73.135.21","51009","50.19.161.202","8080","3","138","3","138","0","0","0.001862000","0.0042","264494.49","N/A"
"131.246.42.106","10612","232.60.178.111","443","3","4332","0","0","3","4332","0.001867000","0.0000","N/A","1332923076.92"
"159.197.185.183","63059","218.51.170.130","80","1","64","0","0","1","64","0.001869000","0.0000","N/A","N/A"
"77.144.1.66","58274","73.38.128.200","53169","1","50","1","50","0","0","0.001882000","0.0000","N/A","N/A"
"34.251.48.54","56734","92.6.239.221","443","6","8976","0","0","6","8976","0.001892000","0.0290","N/A","2471961.17"
"142.85.191.90","1240","36.3.67.144","443","1","1496","0","0","1","1496","0.001943000","0.0000","N/A","N/A"
"7.172.98.129","10599","177.54.88.195","80","1","64","1","64","0","0","0.001947000","0.0000","N/A","N/A"
"95.43.223.203","49777","211.231.161.79","8081","5","230","5","230","0","0","0.001947000","0.0332","55379.98","N/A"
"58.57.179.176","49273","181.175.242.244","80","2","112","2","112","0","0","0.001956000","0.0002","5743589.74","N/A"
"196.37.226.105","20719","211.231.175.194","182","3","228","3","228","0","0","0.001966000","0.0043","422809.46","N/A"
"48.1.210.201","1073","92.52.238.147","443","1","46","1","46","0","0","0.001970000","0.0000","N/A","N/A"
"75.226.253.221","41937","181.175.235.118","80","1","56","0","0","1","56","0.001977000","0.0000","N/A","N/A"
"58.57.201.239","50192","181.175.235.132","80","20","29410","0","0","20","29410","0.001987000","0.0004","N/A","620791556.73"
"196.37.228.136","16743","58.57.248.66","80","1","407","1","407","0","0","0.001989000","0.0000","N/A","N/A"
"219.126.173.58","56661","36.121.241.29","80","1","68","1","68","0","0","0.001999000","0.0000","N/A","N/A"
"83.116.167.132","50029","176.205.174.33","80","1","56","1","56","0","0","0.001999000","0.0000","N/A","N/A"
"140.250.99.252","58170","211.231.161.79","8081","1","46","1","46","0","0","0.002014000","0.0000","N/A","N/A"
"189.164.121.110","52334","215.74.211.245","80","6","7329","0","0","6","7329","0.002047000","0.0008","N/A","71677261.61"
"143.145.125.27","57994","231.69.203.98","54680","2","519","2","519","0","0","0.002058000","0.0000","N/A","N/A"
"241.107.34.61","31716","232.60.178.246","443","1","50","0","0","1","50","0.002067000","0.0000","N/A","N/A"
"131.243.160.189","14600","232.60.178.75","443","11","13555","0","0","11","13555","0.002081000","0.0003","N/A","394327272.73"
"71.215.84.20","54827","181.175.235.132","80","22","31080","0","0","22","31080","0.002083000","0.0003","N/A","967470817.12"
"13.13.159.232","56077","13.13.159.173","179","1","80","0","0","1","80","0.002096000","0.0000","N/A","N/A"
"43.30.166.184","6833","75.179.215.202","443","1","68","1","68","0","0","0.002105000","0.0000","N/A","N/A"
"180.225.134.13","46997","159.240.89.245","211","40","60160","0","0","40","60160","0.002115000","0.0340","N/A","14162792.07"
"180.225.42.87","50337","73.97.113.46","1935","9","8463","0","0","9","8463","0.002118000","0.0280","N/A","2414034.09"
"143.145.30.161","50157","50.19.161.245","8080","19","874","19","874","0","0","0.002122000","0.0343","204038.75","N/A"
"211.231.171.234","8080","151.145.177.123","1600","1","46","0","0","1","46","0.002129000","0.0000","N/A","N/A"
"82.110.200.54","3189","50.19.161.194","80","2","92","2","92","0","0","0.002140000","0.0121","61013.02","N/A"
"211.188.181.96","49197","75.179.10.112","443","1","50","1","50","0","0","0.002153000","0.0000","N/A","N/A"
"138.29.37.238","62262","73.151.138.157","443","1","56","1","56","0","0","0.002169000","0.0000","N/A","N/A"
"131.21.174.165","55186","211.231.170.42","80","5","230","5","230","0","0","0.002169000","0.0290","63498.64","N/A"
"179.181.179.242","56362","58.57.248.119","80","1","46","1","46","0","0","0.002169000","0.0000","N/A","N/A"
"82.147.246.228","63514","177.207.8.33","3389","1","46","1","46","0","0","0.002190000","0.0000","N/A","N/A"
"131.240.238.120","13848","232.60.179.170","443","4","5776","0","0","4","5776","0.002195000","0.0068","N/A","6838537.81"
"232.60.179.236","34270","181.0.183.104","80","5","280","5","280","0","0","0.002227000","0.0003","6686567.16","N/A"
"36.225.212.245","51386","140.104.29.30","25","1","102","0","0","1","102","0.002231000","0.0000","N/A","N/A"
"222.107.109.227","49713","211.231.171.101","80","8","544","8","544","0","0","0.002253000","0.0067","647233.79","N/A"
"56.201.35.84","49851","92.238.81.139","80","1","50","1","50","0","0","0.002263000","0.0000","N/A","N/A"
"232.31.17.220","60806","216.19.0.169","80","1","56","1","56","0","0","0.002264000","0.0000","N/A","N/A"
"135.245.183.114","52369","181.168.232.53","80","1","478","1","478","0","0","0.002281000","0.0000","N/A","N/A"
"150.212.176.92","54865","176.205.174.41","80","1","582","1","582","0","0","0.002294000","0.0000","N/A","N/A"
"141.150.115.232","49590","232.60.179.235","443","1","56","0","0","1","56","0.002334000","0.0000","N/A","N/A"
"89.0.95.70","44493","211.231.170.42","80","7","322","7","322","0","0","0.002341000","0.0098","262669.52","N/A"
"75.224.151.218","34585","243.98.113.151","80","5","6457","0","0","5","6457","0.002346000","0.0305","N/A","1693195.23"
"39.109.242.126","19904","181.175.224.84","443","1","46","0","0","1","46","0.002351000","0.0000","N/A","N/A"
"219.116.119.173","51516","181.168.178.26","8080","4","184","4","184","0","0","0.002381000","0.0320","45929.67","N/A"
"88.193.31.190","12494","232.60.178.101","80","1","1444","0","0","1","1444","0.002411000","0.0000","N/A","N/A"
"71.85.160.16","43784","181.175.235.133","80","2","382","0","0","2","382","0.002433000","0.0112","N/A","274006.99"
"223.144.170.101","51078","181.168.161.170","80","2","92","2","92","0","0","0.002435000","0.0262","28080.89","N/A"
"181.158.212.170","47028","232.21.64.84","443","2","112","2","112","0","0","0.002438000","0.0000","298666666.67","N/A"
"58.57.179.252","59843","50.3.167.10","80","1","56","1","56","0","0","0.002443000","0.0000","N/A","N/A"
"232.31.17.103","56645","71.85.160.9","80","1","56","1","56","0","0","0.002450000","0.0000","N/A","N/A"
"91.23.34.216","4077","176.205.141.124","80","4","200","4","200","0","0","0.002451000","0.0019","822622.11","N/A"
"72.155.46.66","11648","231.154.3.159","1413","7","10333","0","0","7","10333","0.002497000","0.0239","N/A","3461786.51"
"58.57.201.249","61243","181.175.233.22","80","8","11557","0","0","8","11557","0.002511000","0.0000","N/A","1849120000.00"
"71.248.19.84","33988","73.168.180.142","80","7","10046","0","0","7","10046","0.002513000","0.0217","N/A","3698651.57"
"142.70.85.250","10366","232.60.179.147","443","2","2888","0","0","2","2888","0.002535000","0.0000","N/A","1925333333.33"
"222.107.99.187","54093","211.231.164.53","80","8","448","8","448","0","0","0.002536000","0.0330","108665.33","N/A"
"76.179.15.5","65263","73.151.139.148","443","1","577","1","577","0","0","0.002539000","0.0000","N/A","N/A"
"88.195.45.0","3301","232.60.179.221","80","2","2992","0","0","2","2992","0.002540000","0.0012","N/A","19148800.00"
"94.44.215.74","51553","211.231.164.197","8182","3","138","3","138","0","0","0.002549000","0.0271","40780.14","N/A"
"55.156.148.6","2785","80.74.172.154","80","1","56","1","56","0","0","0.002555000","0.0000","N/A","N/A"
"137.101.152.96","1680","73.168.177.160","80","5","7520","0","0","5","7520","0.002573000","0.0006","N/A","104808362.37"
"39.109.242.119","26298","181.175.224.84","443","1","1404","0","0","1","1404","0.002579000","0.0000","N/A","N/A"
"218.239.192.94","52914","70.15.220.69","80","1","56","1","56","0","0","0.002581000","0.0000","N/A","N/A"
"128.113.207.203","40502","211.231.171.122","8777","15","690","15","690","0","0","0.002602000","0.0346","159348.75","N/A"
"131.245.97.108","15554","232.60.178.90","443","12","13502","0","0","12","13502","0.002607000","0.0332","N/A","3251241.61"
"196.37.226.105","20789","211.231.175.194","182","3","228","3","228","0","0","0.002612000","0.0093","196806.21","N/A"
"76.168.101.209","35175","29.22.13.105","80","1","757","1","757","0","0","0.002621000","0.0000","N/A","N/A"
"74.110.251.242","40379","181.175.235.116","80","9","11725","0","0","9","11725","0.002661000","0.0290","N/A","3232922.04"
"137.82.137.221","56481","177.54.88.198","80","1","56","1","56","0","0","0.002680000","0.0000","N/A","N/A"
"75.235.12.69","2228","232.21.93.141","443","1","91","1","91","0","0","0.002691000","0.0000","N/A","N/A"
"36.3.67.185","64009","181.0.183.84","80","4","224","4","224","0","0","0.002699000","0.0001","12190476.19","N/A"
"83.90.167.208","50897","211.231.171.101","80","48","2208","48","2208","0","0","0.002718000","0.0207","854282.54","N/A"
"89.129.205.71","40636","70.7.191.81","80","3","138","3","138","0","0","0.002723000","0.0243","45492.01","N/A"
"79.176.139.163","54293","181.175.235.22","443","2","142","0","0","2","142","0.002735000","0.0004","N/A","2750605.33"
"92.163.79.53","55845","211.163.30.161","7000","1","50","0","0","1","50","0.002745000","0.0000","N/A","N/A"
"180.135.222.67","52719","232.60.179.181","443","1","56","0","0","1","56","0.002757000","0.0000","N/A","N/A"
"140.234.107.210","51361","148.163.17.21","8080","7","392","7","392","0","0","0.002766000","0.0196","160057.16","N/A"
"90.195.40.55","3255","211.231.164.53","80","4","184","4","184","0","0","0.002775000","0.0311","47350.98","N/A"
"43.173.249.83","39813","51.67.118.221","80","2","328","2","328","0","0","0.002784000","0.0000","97185185.19","N/A"
"142.84.51.186","25367","232.60.177.250","443","3","181","0","0","3","181","0.002822000","0.0007","N/A","2151560.18"
"129.121.158.138","62874","92.36.237.106","80","2","158","2","158","0","0","0.002858000","0.0008","1626769.63","N/A"
"39.124.211.72","59967","232.60.179.123","80","1","1496","0","0","1","1496","0.002879000","0.0000","N/A","N/A"
"71.184.180.123","61206","181.175.235.132","80","4","5302","0","0","4","5302","0.002893000","0.0000","N/A","3262769230.77"
"142.224.131.125","51377","232.60.177.170","80","1","50","0","0","1","50","0.002900000","0.0000","N/A","N/A"
"219.211.118.14","61341","211.231.171.101","80","2","92","2","92","0","0","0.002920000","0.0049","149837.13","N/A"
"223.144.77.243","51277","148.163.34.10","8080","2","92","2","92","0","0","0.002953000","0.0211","34919.58","N/A"
"129.198.33.227","50927","232.60.178.89","443","6","8893","0","0","6","8893","0.002960000","0.0001","N/A","1129269841.27"
"83.9.173.142","41686","159.183.100.202","8080","3","168","3","168","0","0","0.002973000","0.0047","287856.07","N/A"
"129.43.140.122","51605","73.228.140.112","8100","1","46","0","0","1","46","0.002977000","0.0000","N/A","N/A"
"231.128.118.149","62619","162.59.10.145","1935","4","5321","4","5321","0","0","0.002987000","0.0340","1253105.68","N/A"
"131.246.27.148","3986","232.60.179.225","443","1","326","0","0","1","326","0.002989000","0.0000","N/A","N/A"
"71.248.19.121","49936","73.168.177.160","80","11","16544","0","0","11","16544","0.002998000","0.0010","N/A","126290076.34"
"222.107.115.117","60871","211.231.171.101","80","1","56","1","56","0","0","0.003007000","0.0000","N/A","N/A"
"82.149.230.235","38823","70.73.206.103","21","1","68","1","68","0","0","0.003024000","0.0000","N/A","N/A"
"148.163.17.21","8080","83.157.49.245","1723","1","46","0","0","1","46","0.003024000","0.0000","N/A","N/A"
"25.96.149.177","61727","211.231.171.101","80","4","224","4","224","0","0","0.003053000","0.0034","529863.99","N/A"
"131.246.216.17","10255","232.60.179.155","443","2","147","0","0","2","147","0.003059000","0.0000","N/A","26133333.33"
"40.171.133.120","60646","211.231.170.130","80","7","322","7","322","0","0","0.003081000","0.0063","406116.98","N/A"
"76.74.129.251","16956","71.231.207.64","80","1","46","1","46","0","0","0.003085000","0.0000","N/A","N/A"
"56.159.152.88","49932","153.231.135.101","14000","2","112","0","0","2","112","0.003089000","0.0003","N/A","3188612.10"
"215.74.154.217","37661","92.238.90.122","636","1","64","1","64","0","0","0.003104000","0.0000","N/A","N/A"
"181.175.224.39","47612","199.174.53.50","80","1","482","1","482","0","0","0.003108000","0.0000","N/A","N/A"
"91.144.48.113","59632","211.231.161.79","8081","7","322","7","322","0","0","0.003112000","0.0329","78221.79","N/A"
"49.132.135.194","12177","186.237.209.199","80","5","7520","0","0","5","7520","0.003117000","0.0008","N/A","74919053.55"
"43.30.195.126","48712","75.179.215.202","443","1","56","1","56","0","0","0.003125000","0.0000","N/A","N/A"
"218.205.236.117","1407","181.168.230.170","80","1","46","1","46","0","0","0.003130000","0.0000","N/A","N/A"
"159.252.235.45","60644","71.199.4.90","80","1","56","1","56","0","0","0.003132000","0.0000","N/A","N/A"
"131.243.40.213","49233","232.60.179.144","80","1","56","0","0","1","56","0.003137000","0.0000","N/A","N/A"
"48.45.175.200","56774","92.185.156.47","80","1","56","1","56","0","0","0.003185000","0.0000","N/A","N/A"
"231.178.253.237","2007","75.179.114.206","80","2","92","2","92","0","0","0.003190000","0.0040","184646.26","N/A"
"181.0.120.4","58240","181.175.235.132","80","40","55939","0","0","40","55939","0.003213000","0.0003","N/A","1603985663.08"
"139.140.25.123","54790","211.231.170.69","80","11","506","11","506","0","0","0.003229000","0.0018","2213231.27","N/A"
"131.243.159.219","13046","232.60.179.245","80","6","8904","0","0","6","8904","0.003235000","0.0123","N/A","5801123.87"
"229.126.233.231","39421","36.225.242.42","8080","2","112","2","112","0","0","0.003237000","0.0000","N/A","N/A"
"43.173.249.234","56480","176.218.185.226","80","19","874","19","874","0","0","0.003239000","0.0023","2977853.49","N/A"
"143.251.47.188","1907","70.7.191.81","80","2","92","2","92","0","0","0.003257000","0.0307","23947.42","N/A"
"181.0.153.163","41098","181.175.235.102","80","1","56","0","0","1","56","0.003260000","0.0000","N/A","N/A"
"88.166.143.86","23356","36.225.122.26","8080","1","46","1","46","0","0","0.003262000","0.0000","N/A","N/A"
"179.158.147.118","36572","179.231.228.111","5647","1","46","1","46","0","0","0.003269000","0.0000","N/A","N/A"
"151.250.26.170","63938","211.231.161.79","8081","7","322","7","322","0","0","0.003273000","0.0035","738108.88","N/A"
"182.103.127.107","35187","92.52.238.137","443","1","157","1","157","0","0","0.003273000","0.0000","N/A","N/A"
"41.35.141.10","17876","92.47.213.116","22","3","210","3","210","0","0","0.003273000","0.0000","60000000.00","N/A"
"229.195.134.55","54568","36.225.122.26","8080","5","280","5","280","0","0","0.003284000","0.0299","75034.33","N/A"
"43.237.21.24","58554","211.231.170.122","80","4","224","4","224","0","0","0.003285000","0.0024","756756.76","N/A"
"36.3.67.178","59500","74.110.251.26","80","2","112","2","112","0","0","0.003289000","0.0014","630985.92","N/A"
"90.59.219.11","62090","211.231.171.101","80","5","230","5","230","0","0","0.003290000","0.0314","58651.03","N/A"
"141.146.89.116","4811","75.226.129.72","443","1","56","0","0","1","56","0.003295000","0.0000","N/A","N/A"
"50.19.250.170","8080","223.144.66.189","1187","1","46","0","0","1","46","0.003302000","0.0000","N/A","N/A"
"148.161.199.177","34759","73.168.180.142","80","14","21056","0","0","14","21056","0.003335000","0.0070","N/A","24212735.37"
"180.238.40.162","53961","73.168.180.142","80","4","6016","0","0","4","6016","0.003341000","0.0000","N/A","6875428571.43"
"137.243.238.145","1584","211.231.164.53","80","11","506","11","506","0","0","0.003344000","0.0285","141935.48","N/A"
"215.74.133.186","49621","181.4.84.87","7001","3","647","3","647","0","0","0.003354000","0.0000","470545454.55","N/A"
"95.39.1.191","63287","181.129.155.184","443","1","46","1","46","0","0","0.003366000","0.0000","N/A","N/A"
"140.250.229.15","52212","211.231.169.234","80","7","322","7","322","0","0","0.003388000","0.0307","83897.86","N/A"
"181.131.148.255","2109","186.237.209.154","80","1","46","0","0","1","46","0.003417000","0.0000","N/A","N/A"
"43.214.208.143","49522","211.231.171.101","80","2","160","2","160","0","0","0.003417000","0.0200","64108.99","N/A"
"232.60.178.226","36179","71.215.84.72","80","2","112","2","112","0","0","0.003422000","0.0001","9050505.05","N/A"
"142.70.233.25","20508","232.60.179.181","80","1","56","0","0","1","56","0.003435000","0.0000","N/A","N/A"
"58.57.227.58","63921","74.110.251.149","80","2","2266","2","2266","0","0","0.003444000","0.0000","18128000000.00","N/A"
"75.226.168.63","41838","181.175.233.23","80","2","124","0","0","2","124","0.003446000","0.0000","N/A","82666666.67"
"140.234.142.220","46224","71.111.86.229","443","1","67","1","67","0","0","0.003446000","0.0000","N/A","N/A"
"129.127.76.87","61579","211.231.170.42","80","4","184","4","184","0","0","0.003449000","0.0176","83626.86","N/A"
"71.215.84.6","40749","181.175.235.116","80","1","56","0","0","1","56","0.003485000","0.0000","N/A","N/A"
"241.107.249.121","42189","232.60.178.116","443","11","13790","0","0","11","13790","0.003505000","0.0002","N/A","548855721.39"
"141.150.205.95","13259","176.205.174.33","80","1","46","1","46","0","0","0.003506000","0.0000","N/A","N/A"
"12.253.77.58","50325","58.57.179.245","80","5","4705","0","0","5","4705","0.003526000","0.0160","N/A","2352794.10"
"142.83.206.12","20614","232.60.179.246","443","4","5776","0","0","4","5776","0.003532000","0.0268","N/A","1724951.47"
"58.57.201.154","64717","181.175.235.132","80","32","44327","0","0","32","44327","0.003541000","0.0002","N/A","1447412244.90"
"142.91.186.178","2365","36.3.67.153","443","1","1404","0","0","1","1404","0.003550000","0.0000","N/A","N/A"
"133.252.8.208","27620","159.183.91.130","80","1","46","1","46","0","0","0.003551000","0.0000","N/A","N/A"
"137.230.161.31","55186","181.0.154.85","465","4","184","4","184","0","0","0.003551000","0.0118","124989.39","N/A"
"179.158.147.117","33914","179.231.229.96","5647","130","5980","130","5980","0","0","0.003566000","0.0299","1597328.88","N/A"
"25.95.55.110","55106","211.231.164.53","80","20","920","20","920","0","0","0.003582000","0.0336","219112.83","N/A"
"216.31.225.79","2974","181.175.237.237","80","1","336","0","0","1","336","0.003616000","0.0000","N/A","N/A"
"55.129.97.68","2679","5.201.113.90","445","1","52","1","52","0","0","0.003618000","0.0000","N/A","N/A"
"191.208.134.124","49842","73.168.28.158","80","5","846","5","846","0","0","0.003623000","0.0095","711746.77","N/A"
"138.31.248.153","2286","73.151.139.186","80","1","454","1","454","0","0","0.003624000","0.0000","N/A","N/A"
"140.196.11.52","52718","211.231.164.53","80","5","230","5","230","0","0","0.003635000","0.0006","3011456.63","N/A"
"71.114.251.140","36277","75.226.129.53","80","2","992","0","0","2","992","0.003644000","0.0003","N/A","25034700.32"
"130.146.205.88","64429","148.163.8.197","8080","5","230","5","230","0","0","0.003645000","0.0301","61113.33","N/A"
"71.147.197.213","43127","36.3.67.225","443","3","4512","0","0","3","4512","0.003649000","0.0000","N/A","1640727272.73"
"222.6.182.78","48902","58.57.201.65","443","4","224","4","224","0","0","0.003651000","0.0002","9582887.70","N/A"
"232.31.17.239","62759","75.226.167.251","80","1","953","1","953","0","0","0.003657000","0.0000","N/A","N/A"
"75.224.151.112","34710","243.98.113.149","80","18","27072","0","0","18","27072","0.003661000","0.0005","N/A","474947368.42"
"232.31.17.112","36955","58.57.100.58","80","2","112","2","112","0","0","0.003673000","0.0003","2604651.16","N/A"
"43.173.250.38","49425","176.27.185.67","80","4","184","4","184","0","0","0.003677000","0.0004","3689223.06","N/A"
"142.83.135.250","27658","232.60.178.233","80","4","5776","0","0","4","5776","0.003720000","0.0000","N/A","1283555555.56"
"142.73.73.176","10501","36.3.67.212","443","2","2888","0","0","2","2888","0.003722000","0.0000","N/A","2888000000.00"
"43.173.249.87","55539","92.163.90.210","80","5","230","5","230","0","0","0.003737000","0.0006","3183391.00","N/A"
"91.106.33.204","58677","211.231.169.234","80","4","184","4","184","0","0","0.003743000","0.0010","1409961.69","N/A"
"142.81.78.77","62686","232.60.178.228","80","11","14897","0","0","11","14897","0.003743000","0.0040","N/A","30140617.10"
"94.253.216.129","62717","36.225.33.122","8080","4","184","4","184","0","0","0.003762000","0.0276","53327.54","N/A"
"232.60.178.218","49372","181.0.183.6","80","5","280","5","280","0","0","0.003792000","0.0003","7516778.52","N/A"
"232.67.52.122","42542","181.255.152.58","80","1","64","0","0","1","64","0.003793000","0.0000","N/A","N/A"
"181.0.120.5","48062","181.175.235.118","80","6","8581","0","0","6","8581","0.003797000","0.0000","N/A","1716200000.00"
"179.231.229.117","35302","179.158.147.116","8443","2","131","0","0","2","131","0.003804000","0.0000","N/A","40307692.31"
"191.93.213.117","23271","73.168.177.160","80","1","50","0","0","1","50","0.003814000","0.0000","N/A","N/A"
"128.10.131.92","57950","231.69.170.150","57069","1","46","1","46","0","0","0.003815000","0.0000","N/A","N/A"
"43.248.106.62","51150","211.231.164.53","80","9","414","9","414","0","0","0.003849000","0.0104","318676.03","N/A"
"131.246.12.27","58483","36.3.67.139","80","4","5061","0","0","4","5061","0.003854000","0.0026","N/A","15290030.21"
"216.115.88.206","60510","179.231.238.134","92","1","583","1","583","0","0","0.003855000","0.0000","N/A","N/A"
"90.32.101.245","51760","211.231.175.116","80","3","138","3","138","0","0","0.003858000","0.0286","38659.52","N/A"
"88.42.200.174","42916","74.116.201.152","80","1","56","1","56","0","0","0.003864000","0.0000","N/A","N/A"
"141.24.11.117","49427","0.216.231.138","24531","1","46","1","46","0","0","0.003871000","0.0000","N/A","N/A"
"91.97.113.62","51355","211.231.170.42","80","2","92","2","92","0","0","0.003874000","0.0311","23691.50","N/A"
"88.42.200.174","42917","74.116.201.145","80","1","56","1","56","0","0","0.003876000","0.0000","N/A","N/A"
"48.3.166.218","41459","58.57.227.42","80","45","67680","0","0","45","67680","0.003881000","0.0320","N/A","16907319.51"
"141.150.239.27","18334","232.60.178.232","443","1","635","0","0","1","635","0.003887000","0.0000","N/A","N/A"
"49.155.246.56","49312","36.225.251.202","80","5","280","5","280","0","0","0.003888000","0.0120","187056.37","N/A"
"231.106.164.77","58902","92.71.193.12","80","3","4144","0","0","3","4144","0.003895000","0.0000","N/A","1381333333.33"
"49.75.128.140","1937","148.163.8.197","80","11","506","11","506","0","0","0.003902000","0.0193","209947.62","N/A"
"58.57.129.241","56115","232.27.0.191","443","1","1352","1","1352","0","0","0.003933000","0.0000","N/A","N/A"
"150.151.57.168","62276","176.205.189.49","80","1","56","1","56","0","0","0.003955000","0.0000","N/A","N/A"
"191.223.14.74","64894","75.179.10.108","80","1","46","1","46","0","0","0.003970000","0.0000","N/A","N/A"
"232.56.226.12","52368","58.57.179.170","80","2","2758","0","0","2","2758","0.003980000","0.0000","N/A","2206400000.00"
"142.70.244.59","12282","232.60.178.235","443","1","52","0","0","1","52","0.003984000","0.0000","N/A","N/A"
"131.247.124.248","49258","36.3.67.166","443","2","1090","0","0","2","1090","0.003984000","0.0008","N/A","10319526.63"
"131.243.192.1","1378","36.3.67.190","443","2","1680","0","0","2","1680","0.004011000","0.0000","N/A","4480000000.00"
"131.253.131.103","10437","36.3.67.216","443","3","4332","0","0","3","4332","0.004013000","0.0056","N/A","6186362.01"
"58.57.179.176","49868","181.175.242.244","80","2","112","2","112","0","0","0.004018000","0.0001","17568627.45","N/A"
"92.238.91.236","47392","74.116.213.190","443","3","732","0","0","3","732","0.004028000","0.0040","N/A","1479535.12"
"43.173.249.139","65515","211.200.51.71","80","4","184","4","184","0","0","0.004055000","0.0000","77473684.21","N/A"
"36.225.110.202","8080","223.153.93.98","1276","1","46","0","0","1","46","0.004082000","0.0000","N/A","N/A"
"142.91.200.12","11575","232.60.179.235","80","1","1484","0","0","1","1484","0.004097000","0.0000","N/A","N/A"
"179.180.188.15","60011","140.219.121.135","13670","6","336","0","0","6","336","0.004104000","0.0196","N/A","137079.91"
"141.150.228.229","20750","81.134.50.197","25","1","46","1","46","0","0","0.004107000","0.0000","N/A","N/A"
"41.35.141.10","49447","92.47.213.204","22","1","56","1","56","0","0","0.004114000","0.0000","N/A","N/A"
"70.135.1.90","1650","181.175.224.85","443","2","92","0","0","2","92","0.004118000","0.0000","N/A","66909090.91"
"232.60.178.250","49041","216.19.1.148","80","3","168","3","168","0","0","0.004132000","0.0001","24000000.00","N/A"
"0.216.57.163","62950","215.74.204.205","443","1","115","0","0","1","115","0.004135000","0.0000","N/A","N/A"
"181.112.35.74","33441","132.42.42.180","1935","1","387","0","0","1","387","0.004158000","0.0000","N/A","N/A"
"229.19.247.172","1095","50.19.161.245","80","8","368","8","368","0","0","0.004170000","0.0000","267636363.64","N/A"
"58.57.179.199","36071","50.3.167.10","80","1","1103","1","1103","0","0","0.004177000","0.0000","N/A","N/A"
"36.3.67.149","38357","181.0.120.98","80","4","224","4","224","0","0","0.004178000","0.0001","12108108.11","N/A"
"41.83.174.33","13048","232.60.179.220","443","6","8664","0","0","6","8664","0.004184000","0.0300","N/A","2312944.24"
"232.31.17.221","63767","74.110.251.194","80","4","224","4","224","0","0","0.004199000","0.0007","2678624.81","N/A"
"181.0.146.79","59983","216.42.62.229","443","3","4413","0","0","3","4413","0.004202000","0.0000","N/A","1471000000.00"
"133.203.14.171","47647","75.179.35.253","80","2","92","2","92","0","0","0.004204000","0.0001","9945945.95","N/A"
"43.30.0.221","61898","81.87.82.39","80","2","615","2","615","0","0","0.004205000","0.0001","73432835.82","N/A"
"141.145.15.81","29749","176.205.174.33","80","1","56","1","56","0","0","0.004228000","0.0000","N/A","N/A"
"181.7.96.130","28267","191.229.193.85","6103","7","322","7","322","0","0","0.004236000","0.0039","667357.51","N/A"
"91.251.68.121","54849","211.231.170.130","80","3","138","3","138","0","0","0.004244000","0.0054","205242.61","N/A"
"89.226.209.116","55036","211.231.164.210","8182","6","276","6","276","0","0","0.004246000","0.0219","100628.93","N/A"
"76.177.228.193","27234","36.3.67.182","443","1","50","0","0","1","50","0.004258000","0.0000","N/A","N/A"
"25.82.16.255","64709","211.231.161.79","8081","6","276","6","276","0","0","0.004270000","0.0274","80463.54","N/A"
"142.89.57.143","49989","232.60.178.212","80","2","2992","0","0","2","2992","0.004294000","0.0000","N/A","2176000000.00"
"142.91.132.186","18658","232.60.179.233","443","3","4332","0","0","3","4332","0.004296000","0.0000","N/A","1237714285.71"
"49.116.48.198","51641","73.151.139.181","443","2","92","2","92","0","0","0.004299000","0.0000","N/A","N/A"
"70.135.1.90","1897","181.175.237.236","443","1","56","0","0","1","56","0.004313000","0.0000","N/A","N/A"
"36.3.67.210","36975","181.0.183.101","80","1","1051","1","1051","0","0","0.004320000","0.0000","N/A","N/A"
"141.145.43.250","5181","192.243.242.142","25","1","52","1","52","0","0","0.004322000","0.0000","N/A","N/A"
"232.60.179.167","39917","181.0.183.117","80","2","112","2","112","0","0","0.004322000","0.0000","28903225.81","N/A"
"142.231.1.223","18782","50.52.227.2","80","1","46","1","46","0","0","0.004345000","0.0000","N/A","N/A"
"232.60.177.145","56306","29.22.12.214","80","1","1445","1","1445","0","0","0.004359000","0.0000","N/A","N/A"
"58.57.179.187","58675","50.3.163.247","80","1","56","1","56","0","0","0.004360000","0.0000","N/A","N/A"
"232.60.177.185","58761","29.22.12.213","80","1","1226","1","1226","0","0","0.004364000","0.0000","N/A","N/A"
"88.193.104.220","60641","232.60.178.102","80","1","1496","0","0","1","1496","0.004365000","0.0000","N/A","N/A"
"148.162.201.230","10370","211.231.161.79","8880","1","56","1","56","0","0","0.004369000","0.0000","N/A","N/A"
"140.217.169.204","53783","211.231.171.101","80","4","184","4","184","0","0","0.004372000","0.0273","53820.84","N/A"
"211.144.0.138","58902","12.254.8.217","4500","1","46","1","46","0","0","0.004379000","0.0000","N/A","N/A"
"43.30.144.53","23583","75.179.215.202","443","1","56","1","56","0","0","0.004391000","0.0000","N/A","N/A"
"136.97.41.168","51486","148.168.216.81","80","3","168","3","168","0","0","0.004417000","0.0000","N/A","N/A"
"209.161.88.200","40487","92.163.70.89","80","1","68","1","68","0","0","0.004419000","0.0000","N/A","N/A"
"92.31.188.164","47950","159.241.155.103","143","1","70","1","70","0","0","0.004425000","0.0000","N/A","N/A"
"143.252.44.197","3555","70.7.191.81","80","4","184","4","184","0","0","0.004441000","0.0115","127666.96","N/A"
"191.121.74.138","41897","232.16.250.73","443","7","5906","7","5906","0","0","0.004446000","0.0218","2170724.98","N/A"
"71.85.125.113","61713","159.231.80.190","80","7","10528","0","0","7","10528","0.004498000","0.0001","N/A","1122986666.67"
"141.148.105.163","51667","211.231.175.53","182","2","92","2","92","0","0","0.004500000","0.0103","71173.00","N/A"
"43.249.103.92","51281","211.231.164.53","80","42","3000","42","3000","0","0","0.004526000","0.0181","1325234.68","N/A"
"43.173.249.93","51148","92.163.90.210","80","1","64","1","64","0","0","0.004549000","0.0000","N/A","N/A"
"49.119.166.81","1298","14.167.111.134","443","1","245","1","245","0","0","0.004568000","0.0000","N/A","N/A"
"159.252.235.36","33701","71.215.84.0","80","2","112","2","112","0","0","0.004574000","0.0004","2123222.75","N/A"
"232.60.177.197","34294","71.85.160.39","80","1","56","1","56","0","0","0.004576000","0.0000","N/A","N/A"
"151.235.173.104","60284","75.179.10.103","443","1","56","1","56","0","0","0.004585000","0.0000","N/A","N/A"
"232.60.179.149","62512","181.0.120.135","80","4","224","4","224","0","0","0.004602000","0.0002","7690987.12","N/A"
"70.135.1.15","57173","50.3.145.217","443","1","1363","0","0","1","1363","0.004617000","0.0000","N/A","N/A"
"56.159.144.86","12604","211.188.144.26","80","1","64","0","0","1","64","0.004649000","0.0000","N/A","N/A"
"232.31.17.255","43904","58.57.100.117","80","1","56","1","56","0","0","0.004688000","0.0000","N/A","N/A"
"142.85.218.150","20016","36.3.67.218","80","2","2888","0","0","2","2888","0.004694000","0.0000","N/A","1283555555.56"
"231.128.79.10","61668","72.155.44.125","11705","7","5208","7","5208","0","0","0.004699000","0.0281","1482862.94","N/A"
"211.144.0.138","59305","12.254.8.217","4500","1","46","1","46","0","0","0.004710000","0.0000","N/A","N/A"
"77.123.189.209","63768","29.22.12.199","80","1","1183","1","1183","0","0","0.004722000","0.0000","N/A","N/A"
"177.173.226.120","39028","95.166.128.232","80","3","4488","0","0","3","4488","0.004725000","0.0026","N/A","13900116.14"
"138.26.107.85","13054","176.205.189.82","80","1","46","1","46","0","0","0.004727000","0.0000","N/A","N/A"
"75.224.151.233","65364","243.98.113.148","80","7","10528","0","0","7","10528","0.004779000","0.0001","N/A","794566037.74"
"138.165.183.71","49362","232.60.178.116","443","1","56","0","0","1","56","0.004788000","0.0000","N/A","N/A"
"88.195.140.248","10058","36.3.67.203","80","2","2888","0","0","2","2888","0.004800000","0.0028","N/A","8204545.45"
"77.140.200.39","65201","211.231.164.165","8182","2","92","2","92","0","0","0.004818000","0.0040","185390.43","N/A"
"0.216.215.106","55161","231.178.183.60","24323","1","250","0","0","1","250","0.004824000","0.0000","N/A","N/A"
"135.211.216.231","49757","211.231.161.79","8081","1","46","1","46","0","0","0.004830000","0.0000","N/A","N/A"
"133.203.23.204","55212","71.215.84.2","80","2","112","2","112","0","0","0.004878000","0.0231","38776.13","N/A"
"142.85.81.102","15714","36.3.67.225","80","2","2888","0","0","2","2888","0.004881000","0.0000","N/A","2100363636.36"
"232.60.179.230","47591","74.110.251.245","80","1","56","1","56","0","0","0.004882000","0.0000","N/A","N/A"
"95.150.96.158","55840","211.231.171.101","80","23","1088","23","1088","0","0","0.004882000","0.0267","326530.61","N/A"
"135.174.215.243","4102","211.231.164.61","80","3","138","3","138","0","0","0.004893000","0.0127","86690.22","N/A"
"83.116.92.70","54683","211.231.170.42","80","1","46","1","46","0","0","0.004957000","0.0000","N/A","N/A"
"48.215.196.15","8048","80.90.84.26","80","4","224","4","224","0","0","0.004973000","0.0000","896000000.00","N/A"
"223.153.119.95","50233","36.225.122.26","8080","2","92","2","92","0","0","0.005010000","0.0040","184092.05","N/A"
"94.244.65.102","52004","211.231.170.42","80","2","92","2","92","0","0","0.005032000","0.0233","31597.48","N/A"
"142.84.138.47","10370","232.60.178.109","443","3","4332","0","0","3","4332","0.005045000","0.0000","N/A","1506782608.70"
"142.91.165.41","23455","36.3.67.225","80","4","5776","0","0","4","5776","0.005048000","0.0001","N/A","745290322.58"
"204.78.138.119","2485","26.32.95.169","80","3","138","3","138","0","0","0.005054000","0.0133","83020.00","N/A"
"141.35.144.194","15552","81.87.82.39","80","1","56","1","56","0","0","0.005092000","0.0000","N/A","N/A"
"141.148.70.231","26086","58.57.200.97","443","2","687","2","687","0","0","0.005092000","0.0100","550370.52","N/A"
"133.203.13.228","33719","181.9.99.73","80","1","56","1","56","0","0","0.005099000","0.0000","N/A","N/A"
"70.135.1.21","49285","181.175.231.233","443","3","1606","0","0","3","1606","0.005100000","0.0002","N/A","79801242.24"
"43.30.158.37","26467","73.151.139.162","443","1","46","1","46","0","0","0.005101000","0.0000","N/A","N/A"
"232.31.17.103","44022","75.226.244.175","80","1","56","1","56","0","0","0.005111000","0.0000","N/A","N/A"
"43.173.249.87","55539","92.163.83.98","80","4","184","4","184","0","0","0.005115000","0.0000","77473684.21","N/A"
"49.116.48.198","51637","73.151.139.181","443","2","92","2","92","0","0","0.005131000","0.0000","N/A","N/A"
"129.126.248.90","60031","211.231.161.181","80","8","368","8","368","0","0","0.005149000","0.0305","96455.02","N/A"
"229.225.164.134","1355","36.3.67.203","443","1","56","0","0","1","56","0.005164000","0.0000","N/A","N/A"
"129.198.42.112","50723","159.183.108.58","8080","6","276","6","276","0","0","0.005186000","0.0297","74308.41","N/A"
"91.26.58.122","2459","203.155.78.16","445","1","52","1","52","0","0","0.005189000","0.0000","N/A","N/A"
"179.23.112.124","49171","71.71.101.138","443","3","173","0","0","3","173","0.005193000","0.0257","N/A","53852.14"
"131.247.216.66","62124","36.3.67.181","443","1","1496","0","0","1","1496","0.005196000","0.0000","N/A","N/A"
"36.86.243.14","55269","58.57.227.68","80","12","18048","0","0","12","18048","0.005233000","0.0003","N/A","534755555.56"
"131.240.150.202","18726","232.60.178.88","443","3","4332","0","0","3","4332","0.005240000","0.0305","N/A","1135554.90"
"142.81.229.211","26518","36.3.67.218","80","2","2992","0","0","2","2992","0.005241000","0.0000","N/A","3989333333.33"
"180.229.25.88","53620","73.177.182.33","80","1","46","0","0","1","46","0.005251000","0.0000","N/A","N/A"
"140.196.46.159","49223","211.231.171.101","80","6","276","6","276","0","0","0.005253000","0.0191","115759.67","N/A"
"77.140.201.16","57565","81.142.160.104","39658","1","68","1","68","0","0","0.005261000","0.0000","N/A","N/A"
"151.237.28.54","55011","148.163.8.197","8080","1","46","1","46","0","0","0.005267000","0.0000","N/A","N/A"
"71.215.84.81","49233","181.175.235.117","80","8","11469","0","0","8","11469","0.005284000","0.0000","N/A","3528923076.92"
"142.89.162.174","50359","232.60.179.253","80","2","2992","0","0","2","2992","0.005287000","0.0000","N/A","2176000000.00"
"58.57.201.155","54077","181.175.235.117","80","1","56","0","0","1","56","0.005288000","0.0000","N/A","N/A"
"223.31.95.165","4073","211.231.170.42","80","2","92","2","92","0","0","0.005291000","0.0094","78065.34","N/A"
"40.170.90.210","54501","211.231.170.69","80","6","276","6","276","0","0","0.005291000","0.0318","69536.74","N/A"
"74.110.251.254","51728","181.175.235.118","80","36","50188","0","0","36","50188","0.005322000","0.0005","N/A","781136186.77"
"90.195.104.234","53074","211.231.169.226","80","2","92","2","92","0","0","0.005331000","0.0200","36816.57","N/A"
"131.246.103.81","2118","36.3.67.217","443","2","2992","0","0","2","2992","0.005338000","0.0000","N/A","772129032.26"
"73.181.84.9","50343","73.168.177.161","80","7","8792","0","0","7","8792","0.005341000","0.0000","N/A","8792000000.00"
"48.3.211.181","53595","232.60.179.202","80","43","64672","0","0","43","64672","0.005356000","0.0231","N/A","22430243.65"
"141.148.105.163","51668","211.231.175.53","182","2","92","2","92","0","0","0.005373000","0.0296","24888.41","N/A"
"71.85.160.62","44369","181.175.235.118","80","4","5153","0","0","4","5153","0.005382000","0.0000","N/A","4122400000.00"
"232.35.1.216","51247","29.22.12.201","80","1","56","1","56","0","0","0.005383000","0.0000","N/A","N/A"
"211.231.161.79","8081","76.212.222.228","2948","6","276","0","0","6","276","0.005448000","0.0299","N/A","73747.49"
"90.123.158.76","3973","176.205.174.33","80","2","642","2","642","0","0","0.005454000","0.0005","9582089.55","N/A"
"43.30.249.102","29575","74.116.201.121","80","3","180","3","180","0","0","0.005496000","0.0001","9863013.70","N/A"
"131.249.168.26","25533","232.60.179.226","80","3","4458","0","0","3","4458","0.005581000","0.0000","N/A","1486000000.00"
"137.9.146.50","53161","177.54.76.33","80","1","206","1","206","0","0","0.005586000","0.0000","N/A","N/A"
"140.240.53.141","59727","211.231.171.101","80","22","1032","22","1032","0","0","0.005606000","0.0063","1310476.19","N/A"
"80.112.233.61","41140","75.179.194.139","80","2","112","2","112","0","0","0.005610000","0.0261","34322.93","N/A"
"140.193.240.226","1377","211.231.164.53","80","4","184","4","184","0","0","0.005613000","0.0034","437314.32","N/A"
"137.135.176.198","26501","181.9.99.136","443","1","56","1","56","0","0","0.005618000","0.0000","N/A","N/A"
"90.194.91.189","53973","211.231.161.79","8081","4","184","4","184","0","0","0.005631000","0.0303","48560.02","N/A"
"142.91.115.192","13452","232.60.178.253","80","1","56","0","0","1","56","0.005638000","0.0000","N/A","N/A"
"142.70.230.72","23393","36.3.67.201","443","2","147","0","0","2","147","0.005676000","0.0000","N/A","N/A"
"90.229.74.175","59652","211.231.175.116","80","3","138","3","138","0","0","0.005682000","0.0238","46332.05","N/A"
"141.27.55.238","50817","58.57.200.86","443","1","46","1","46","0","0","0.005682000","0.0000","N/A","N/A"
"39.109.242.125","59257","181.175.235.62","80","1","202","0","0","1","202","0.005689000","0.0000","N/A","N/A"
"229.132.230.169","20773","179.141.107.93","25","1","46","1","46","0","0","0.005689000","0.0000","N/A","N/A"
"95.165.137.123","3083","73.151.139.163","443","1","46","1","46","0","0","0.005697000","0.0000","N/A","N/A"
"222.108.162.102","57658","211.231.161.79","8081","3","138","3","138","0","0","0.005711000","0.0041","272390.82","N/A"
"181.157.89.2","59536","179.22.29.160","6680","1","50","1","50","0","0","0.005744000","0.0000","N/A","N/A"
"94.40.151.252","3577","211.231.169.234","80","11","506","11","506","0","0","0.005752000","0.0308","131501.15","N/A"
"150.148.224.67","50069","36.225.47.154","8080","1","46","1","46","0","0","0.005758000","0.0000","N/A","N/A"
"5.38.47.177","65272","148.166.46.186","80","1","58","1","58","0","0","0.005791000","0.0000","N/A","N/A"
"187.232.176.211","50350","71.85.124.136","443","3","166","3","166","0","0","0.005800000","0.0133","99767.11","N/A"
"205.203.93.88","50323","148.169.182.194","80","1","46","1","46","0","0","0.005816000","0.0000","N/A","N/A"
"73.235.186.32","23812","77.232.165.10","1739","4","4744","0","0","4","4744","0.005832000","0.0004","N/A","86058956.92"
"142.70.181.146","1560","232.60.179.160","80","1","1496","0","0","1","1496","0.005838000","0.0000","N/A","N/A"
"218.239.167.159","58502","181.131.172.243","51282","1","46","1","46","0","0","0.005846000","0.0000","N/A","N/A"
"72.83.168.187","38165","75.179.10.116","80","1","482","1","482","0","0","0.005873000","0.0000","N/A","N/A"
"148.161.198.253","35793","73.168.180.142","80","1","50","0","0","1","50","0.005873000","0.0000","N/A","N/A"
"232.31.17.122","59339","58.57.100.110","80","1","891","1","891","0","0","0.005899000","0.0000","N/A","N/A"
"76.150.157.38","61865","71.215.84.85","80","1","978","1","978","0","0","0.005920000","0.0000","N/A","N/A"
"141.66.74.149","39764","186.237.209.222","80","5","6214","0","0","5","6214","0.005924000","0.0001","N/A","637333333.33"
"131.249.185.122","49493","36.3.67.201","80","1","56","0","0","1","56","0.005971000","0.0000","N/A","N/A"
"41.47.111.217","53729","0.216.41.141","4662","1","52","1","52","0","0","0.006004000","0.0000","N/A","N/A"
"92.163.79.53","34380","211.163.30.161","6667","1","50","0","0","1","50","0.006004000","0.0000","N/A","N/A"
"72.157.218.221","50615","211.188.19.162","443","1","56","0","0","1","56","0.006036000","0.0000","N/A","N/A"
"188.69.84.130","2658","75.179.10.106","80","1","46","1","46","0","0","0.006039000","0.0000","N/A","N/A"
"181.0.183.82","37683","181.175.235.133","80","65","90821","0","0","65","90821","0.006045000","0.0004","N/A","1705558685.45"
"36.225.176.109","57638","76.90.27.61","80","2","3008","0","0","2","3008","0.006074000","0.0001","N/A","209252173.91"
"142.89.56.118","26065","232.60.178.247","443","4","237","0","0","4","237","0.006109000","0.0020","N/A","944223.11"
"181.9.99.79","58720","181.175.233.22","80","5","6618","0","0","5","6618","0.006119000","0.0000","N/A","3309000000.00"
"232.60.179.143","54471","181.0.183.5","80","3","168","3","168","0","0","0.006139000","0.0001","11487179.49","N/A"
"13.158.251.252","50634","75.179.10.107","80","1","975","1","975","0","0","0.006143000","0.0000","N/A","N/A"
"58.57.201.71","41096","181.175.231.233","443","1","56","0","0","1","56","0.006144000","0.0000","N/A","N/A"
"232.56.227.58","57364","58.57.179.219","80","1","258","0","0","1","258","0.006148000","0.0000","N/A","N/A"
"131.245.95.102","26824","36.3.67.144","80","2","2888","0","0","2","2888","0.006151000","0.0000","N/A","2310400000.00"
"29.22.12.185","55074","181.175.235.117","80","1","56","0","0","1","56","0.006163000","0.0000","N/A","N/A"
"131.253.245.93","10234","232.60.179.246","443","2","2888","0","0","2","2888","0.006165000","0.0044","N/A","5249715.97"
"36.3.67.149","48216","74.110.251.213","80","2","112","2","112","0","0","0.006167000","0.0000","47157894.74","N/A"
"181.0.142.36","39748","181.175.233.22","80","1","56","0","0","1","56","0.006171000","0.0000","N/A","N/A"
"143.7.13.143","49234","182.46.171.200","443","1","313","0","0","1","313","0.006194000","0.0000","N/A","N/A"
"131.50.222.153","53020","36.225.128.154","8080","2","92","2","92","0","0","0.006216000","0.0040","183039.05","N/A"
"142.83.200.90","24984","232.60.179.221","443","4","277","0","0","4","277","0.006227000","0.0010","N/A","2303534.30"
"50.46.75.142","46180","36.3.67.181","443","4","5772","0","0","4","5772","0.006235000","0.0000","N/A","1649142857.14"
"229.134.227.35","3360","176.205.189.53","80","1","46","1","46","0","0","0.006239000","0.0000","N/A","N/A"
"82.154.58.78","57549","211.231.170.42","80","9","450","9","450","0","0","0.006245000","0.0065","551217.27","N/A"
"88.195.144.142","50838","232.60.178.222","80","1","56","0","0","1","56","0.006259000","0.0000","N/A","N/A"
"43.30.249.102","12676","74.116.201.200","80","6","360","6","360","0","0","0.006303000","0.0001","20000000.00","N/A"
"133.203.13.253","38633","36.123.19.237","80","33","48269","33","48269","0","0","0.006309000","0.0008","481486284.29","N/A"
"50.46.98.205","50420","232.60.178.65","443","10","15040","0","0","10","15040","0.006316000","0.0001","N/A","1114074074.07"
"138.25.191.167","1135","73.151.139.186","80","1","466","1","466","0","0","0.006351000","0.0000","N/A","N/A"
"232.23.227.20","64837","191.121.75.158","9050","1","100","0","0","1","100","0.006358000","0.0000","N/A","N/A"
"151.238.47.7","42583","181.168.161.170","8080","5","280","5","280","0","0","0.006363000","0.0039","570555.27","N/A"
"49.118.232.151","29373","71.85.125.218","80","4","224","4","224","0","0","0.006366000","0.0056","320629.81","N/A"
"77.133.228.9","53470","211.231.171.101","80","8","368","8","368","0","0","0.006372000","0.0192","153285.43","N/A"
"58.57.201.141","53021","181.175.235.132","80","1","56","0","0","1","56","0.006376000","0.0000","N/A","N/A"
"131.243.247.86","51576","75.226.129.55","80","7","10388","0","0","7","10388","0.006394000","0.0072","N/A","11569539.19"
"176.210.78.154","47508","176.218.155.149","80","1","255","0","0","1","255","0.006406000","0.0000","N/A","N/A"
"138.243.220.124","39122","176.218.188.101","80","1","56","1","56","0","0","0.006411000","0.0000","N/A","N/A"
"141.145.97.8","42820","176.205.174.33","80","1","56","1","56","0","0","0.006419000","0.0000","N/A","N/A"
"77.252.136.34","30063","232.60.179.246","80","6","8924","0","0","6","8924","0.006436000","0.0001","N/A","1170360655.74"
"181.0.120.79","60318","181.175.233.22","443","1","56","0","0","1","56","0.006437000","0.0000","N/A","N/A"
"58.57.201.154","57013","181.175.235.118","80","1","56","0","0","1","56","0.006447000","0.0000","N/A","N/A"
"148.161.202.55","45852","191.235.251.221","1935","1","62","1","62","0","0","0.006447000","0.0000","N/A","N/A"
"215.74.154.217","60245","92.238.90.110","7435","1","64","1","64","0","0","0.006447000","0.0000","N/A","N/A"
"75.28.128.112","47702","72.192.80.170","80","1","107","0","0","1","107","0.006462000","0.0000","N/A","N/A"
"130.146.120.161","51423","36.225.128.154","8080","4","214","4","214","0","0","0.006468000","0.0281","60992.55","N/A"
"94.247.51.100","54342","211.231.171.101","80","3","138","3","138","0","0","0.006480000","0.0300","36825.78","N/A"
"36.196.245.117","8066","73.228.135.230","80","5","6731","0","0","5","6731","0.006481000","0.0000","N/A","1313365853.66"
"142.83.162.27","18739","232.60.178.213","443","1","1444","0","0","1","1444","0.006483000","0.0000","N/A","N/A"
"229.5.83.41","54613","176.205.189.82","80","2","92","2","92","0","0","0.006484000","0.0000","32000000.00","N/A"
"181.9.99.115","48239","181.175.235.118","80","1","56","0","0","1","56","0.006503000","0.0000","N/A","N/A"
"196.37.208.125","20870","36.225.251.202","80","1","953","1","953","0","0","0.006544000","0.0000","N/A","N/A"
"132.176.240.27","3263","211.231.170.42","80","1","50","1","50","0","0","0.006545000","0.0000","N/A","N/A"
"231.178.158.254","64178","72.155.46.67","11305","9","12437","9","12437","0","0","0.006550000","0.0249","3996946.93","N/A"
"71.126.31.162","54902","181.175.235.132","80","1","56","0","0","1","56","0.006552000","0.0000","N/A","N/A"
"58.57.179.255","39130","181.175.245.233","80","2","112","2","112","0","0","0.006554000","0.0002","5818181.82","N/A"
"90.213.97.191","49450","181.168.161.170","80","2","92","2","92","0","0","0.006572000","0.0108","67896.68","N/A"
"50.46.199.3","62189","154.239.236.241","56948","1","46","0","0","1","46","0.006576000","0.0000","N/A","N/A"
"222.188.226.230","18604","75.179.215.202","443","1","513","1","513","0","0","0.006588000","0.0000","N/A","N/A"
"142.89.251.47","1985","232.60.178.103","443","2","1066","0","0","2","1066","0.006604000","0.0114","N/A","747087.17"
"131.246.55.85","21041","36.3.67.136","443","1","1444","0","0","1","1444","0.006613000","0.0000","N/A","N/A"
"132.42.200.198","49616","36.3.67.153","80","9","10537","0","0","9","10537","0.006616000","0.0001","N/A","593633802.82"
"141.148.138.237","14161","176.205.174.33","80","1","46","1","46","0","0","0.006629000","0.0000","N/A","N/A"
"223.153.109.40","62852","36.225.173.101","8080","2","92","2","92","0","0","0.006630000","0.0038","195432.82","N/A"
"50.45.230.170","45299","73.97.113.82","80","29","43616","0","0","29","43616","0.006634000","0.0085","N/A","40987665.92"
"232.60.177.220","33218","29.22.12.168","80","1","918","1","918","0","0","0.006635000","0.0000","N/A","N/A"
"70.135.1.21","56598","181.175.237.236","443","3","4089","0","0","3","4089","0.006638000","0.0000","N/A","4673142857.14"
"196.37.228.136","16741","58.57.248.66","80","1","411","1","411","0","0","0.006645000","0.0000","N/A","N/A"
"131.50.125.9","51761","181.168.230.74","8080","18","828","18","828","0","0","0.006650000","0.0120","552138.03","N/A"
"219.209.138.122","51965","211.231.170.53","80","34","1904","34","1904","0","0","0.006651000","0.0226","674489.66","N/A"
"43.173.249.233","59470","75.179.26.38","80","1","64","1","64","0","0","0.006673000","0.0000","N/A","N/A"
"231.177.130.232","29082","232.19.58.166","443","1","56","1","56","0","0","0.006688000","0.0000","N/A","N/A"
"49.78.202.83","57365","187.132.166.152","51413","1","56","1","56","0","0","0.006734000","0.0000","N/A","N/A"
"232.31.17.204","33808","14.167.111.245","80","2","112","2","112","0","0","0.006736000","0.0000","64000000.00","N/A"
"94.252.19.68","52290","148.163.34.10","8080","8","368","8","368","0","0","0.006738000","0.0304","96886.72","N/A"
"181.0.183.187","51272","181.175.233.22","80","3","4309","0","0","3","4309","0.006778000","0.0000","N/A","6894400000.00"
"150.3.228.222","1909","70.7.191.81","80","1","46","1","46","0","0","0.006784000","0.0000","N/A","N/A"
"138.26.36.33","24950","58.57.200.97","443","1","244","1","244","0","0","0.006805000","0.0000","N/A","N/A"
"71.248.19.93","56060","73.168.182.201","80","6","9024","0","0","6","9024","0.006815000","0.0008","N/A","86665066.03"
"219.209.232.90","50224","211.231.164.237","8182","9","414","9","414","0","0","0.006816000","0.0129","256267.41","N/A"
"71.248.19.65","45551","73.168.180.142","80","7","10528","0","0","7","10528","0.006819000","0.0287","N/A","2935861.68"
"43.30.232.215","45707","71.85.125.234","80","14","944","14","944","0","0","0.006824000","0.0005","13933579.34","N/A"
"83.229.227.29","31447","73.151.139.162","443","2","293","2","293","0","0","0.006840000","0.0009","2684994.27","N/A"
"215.75.252.208","54817","75.179.10.118","80","2","112","2","112","0","0","0.006864000","0.0002","3612903.23","N/A"
"229.195.159.224","50982","181.168.161.170","8080","3","138","3","138","0","0","0.006877000","0.0080","138069.03","N/A"
"92.37.105.204","62122","77.140.202.232","44957","2","112","0","0","2","112","0.006889000","0.0040","N/A","225295.45"
"135.254.158.173","60004","211.200.228.231","80","1","46","1","46","0","0","0.006898000","0.0000","N/A","N/A"
"142.91.178.37","49451","232.60.179.221","80","2","2992","0","0","2","2992","0.006913000","0.0000","N/A","2393600000.00"
"129.120.169.28","4709","211.231.170.106","80","1","46","1","46","0","0","0.006914000","0.0000","N/A","N/A"
"232.60.179.243","34349","181.0.120.74","80","1","56","1","56","0","0","0.006960000","0.0000","N/A","N/A"
"71.126.3.195","44597","181.175.224.85","443","3","2612","0","0","3","2612","0.006983000","0.0001","N/A","232177777.78"
"219.107.251.1","51920","176.205.174.41","80","1","46","1","46","0","0","0.006984000","0.0000","N/A","N/A"
"91.157.216.102","64377","211.231.170.42","80","2","92","2","92","0","0","0.007074000","0.0162","45555.83","N/A"
"217.12.16.178","37597","58.57.179.201","80","2","1620","0","0","2","1620","0.007077000","0.0000","N/A","12960000000.00"
"140.196.22.206","54934","211.231.170.42","80","2","92","2","92","0","0","0.007090000","0.0008","874109.26","N/A"
"232.60.179.166","52164","71.215.84.0","80","2","112","2","112","0","0","0.007091000","0.0001","11200000.00","N/A"
"191.203.28.207","57932","177.143.85.100","80","2","1362","2","1362","0","0","0.007102000","0.0003","32047058.82","N/A"
"90.46.198.53","57597","148.166.35.53","80","3","4272","3","4272","0","0","0.007118000","0.0269","1271949.09","N/A"
"148.161.198.249","45815","73.168.180.142","80","2","3008","0","0","2","3008","0.007119000","0.0000","N/A","12032000000.00"
"150.224.238.82","65268","74.116.201.134","80","1","46","1","46","0","0","0.007124000","0.0000","N/A","N/A"
"55.143.241.146","41774","73.100.8.194","80","1","511","1","511","0","0","0.007145000","0.0000","N/A","N/A"
"142.84.135.65","51415","232.60.179.181","443","1","1484","0","0","1","1484","0.007151000","0.0000","N/A","N/A"
"215.74.154.217","42969","92.238.90.40","5903","1","64","1","64","0","0","0.007165000","0.0000","N/A","N/A"
"6.168.23.254","48329","181.9.99.101","443","5","280","5","280","0","0","0.007169000","0.0003","7619047.62","N/A"
"188.247.41.250","45950","191.250.205.154","8640","3","138","0","0","3","138","0.007178000","0.0241","N/A","45811.03"
"215.74.154.217","60650","92.238.90.78","2260","1","64","1","64","0","0","0.007185000","0.0000","N/A","N/A"
"95.154.80.193","62999","178.61.254.98","9510","1","46","1","46","0","0","0.007196000","0.0000","N/A","N/A"
"70.135.1.96","34151","181.175.224.85","443","1","56","0","0","1","56","0.007197000","0.0000","N/A","N/A"
"91.27.71.149","49906","211.231.170.42","80","1","46","1","46","0","0","0.007205000","0.0000","N/A","N/A"
"232.58.59.139","38024","133.203.1.93","443","1","733","0","0","1","733","0.007250000","0.0000","N/A","N/A"
"142.85.5.143","61162","232.60.178.72","80","3","4452","0","0","3","4452","0.007262000","0.0000","N/A","1079272727.27"
"128.10.135.98","59986","36.86.72.56","5222","1","56","1","56","0","0","0.007276000","0.0000","N/A","N/A"
"138.31.88.163","50672","176.205.174.33","80","2","754","2","754","0","0","0.007286000","0.0059","1023240.03","N/A"
"142.73.7.153","12062","232.60.178.111","443","1","56","0","0","1","56","0.007302000","0.0000","N/A","N/A"
"132.42.61.70","50956","36.3.137.115","443","1","701","1","701","0","0","0.007335000","0.0000","N/A","N/A"
"142.70.84.232","49525","232.60.178.103","80","3","4488","0","0","3","4488","0.007363000","0.0000","N/A","1238068965.52"
"43.173.249.108","43472","177.54.80.213","80","1","64","1","64","0","0","0.007372000","0.0000","N/A","N/A"
"232.31.17.220","46513","181.9.99.101","80","5","280","5","280","0","0","0.007377000","0.0098","229226.36","N/A"
"148.168.211.243","31359","71.212.187.108","80","4","6016","0","0","4","6016","0.007398000","0.0000","N/A","4010666666.67"
"77.140.195.142","55087","148.168.216.75","80","2","92","2","92","0","0","0.007400000","0.0040","186234.82","N/A"
"191.121.73.237","55451","14.167.111.144","80","2","112","2","112","0","0","0.007412000","0.0001","8871287.13","N/A"
"205.203.241.119","6034","211.231.170.42","80","5","250","5","250","0","0","0.007417000","0.0282","70861.68","N/A"
"129.243.224.124","9606","74.78.235.17","2193","2","92","2","92","0","0","0.007426000","0.0294","25058.73","N/A"
"138.31.248.153","2284","73.151.139.186","80","1","455","1","455","0","0","0.007433000","0.0000","N/A","N/A"
"142.83.231.151","59395","36.3.67.168","443","1","50","0","0","1","50","0.007443000","0.0000","N/A","N/A"
"88.193.97.45","17323","232.60.178.234","80","1","1444","0","0","1","1444","0.007451000","0.0000","N/A","N/A"
"49.112.154.118","52535","73.151.139.186","80","2","606","2","606","0","0","0.007466000","0.0068","714201.53","N/A"
"91.145.80.242","50295","211.231.171.101","80","4","224","4","224","0","0","0.007490000","0.0238","75287.79","N/A"
"218.37.69.37","36400","71.85.125.148","80","1","1034","1","1034","0","0","0.007515000","0.0000","N/A","N/A"
"232.60.179.240","39837","71.126.28.171","80","5","280","5","280","0","0","0.007516000","0.0007","3313609.47","N/A"
"231.176.240.85","2219","211.188.187.233","80","1","390","0","0","1","390","0.007535000","0.0000","N/A","N/A"
"140.215.110.134","3603","211.231.170.42","80","3","138","3","138","0","0","0.007535000","0.0047","235998.29","N/A"
"218.37.69.239","39977","181.9.99.89","80","1","1382","1","1382","0","0","0.007553000","0.0000","N/A","N/A"
"137.231.59.175","42141","211.231.175.234","8777","1","56","1","56","0","0","0.007598000","0.0000","N/A","N/A"
"142.70.107.128","11113","232.60.179.144","80","5","7220","0","0","5","7220","0.007605000","0.0102","N/A","5672755.84"
"88.193.65.91","55076","232.60.179.168","443","3","4488","0","0","3","4488","0.007608000","0.0187","N/A","1917027.07"
"6.168.23.193","53180","71.215.84.62","80","4","224","4","224","0","0","0.007609000","0.0002","8784313.73","N/A"
"139.153.30.152","61297","211.231.171.252","80","17","782","17","782","0","0","0.007609000","0.0149","420712.84","N/A"
"138.25.183.60","1530","36.3.67.188","80","1","1079","0","0","1","1079","0.007613000","0.0000","N/A","N/A"
"142.89.125.121","14075","36.3.67.168","443","1","50","0","0","1","50","0.007636000","0.0000","N/A","N/A"
"148.161.192.173","35059","73.168.182.201","80","1","50","0","0","1","50","0.007636000","0.0000","N/A","N/A"
"71.85.125.163","37991","181.175.235.117","80","1","56","0","0","1","56","0.007650000","0.0000","N/A","N/A"
"58.57.201.125","60952","181.175.235.116","80","1","56","0","0","1","56","0.007650000","0.0000","N/A","N/A"
"138.251.228.96","3312","70.7.191.81","80","1","46","1","46","0","0","0.007665000","0.0000","N/A","N/A"
"142.85.255.118","52535","232.60.178.230","80","2","2992","0","0","2","2992","0.007673000","0.0046","N/A","5183196.19"
"229.195.144.21","50387","50.19.161.202","8080","6","336","6","336","0","0","0.007675000","0.0199","134872.05","N/A"
"232.31.17.253","48809","75.226.253.200","80","3","168","3","168","0","0","0.007687000","0.0003","4048192.77","N/A"
"95.60.142.95","51006","211.231.175.252","80","3","138","3","138","0","0","0.007688000","0.0221","49887.03","N/A"
"142.91.192.170","51185","232.60.178.118","443","2","2992","0","0","2","2992","0.007702000","0.0015","N/A","15830687.83"
"229.195.120.98","50176","36.225.128.154","8080","3","138","3","138","0","0","0.007797000","0.0199","55382.76","N/A"
"219.211.54.43","53906","211.231.164.53","80","1","46","1","46","0","0","0.007814000","0.0000","N/A","N/A"
"75.226.244.163","51779","181.175.233.23","80","5","6093","0","0","5","6093","0.007829000","0.0000","N/A","1572387096.77"
"89.123.98.250","1530","211.231.164.53","80","12","552","12","552","0","0","0.007841000","0.0047","944396.92","N/A"
"50.46.1.240","52315","232.60.176.62","80","4","6016","0","0","4","6016","0.007846000","0.0000","N/A","1300756756.76"
"232.60.178.98","51142","71.215.84.65","80","3","168","3","168","0","0","0.007847000","0.0226","59455.87","N/A"
"131.242.240.133","10928","36.3.67.168","443","1","50","0","0","1","50","0.007850000","0.0000","N/A","N/A"
"90.119.157.92","57559","211.231.171.101","80","4","184","4","184","0","0","0.007885000","0.0004","3764705.88","N/A"
"92.241.183.234","12119","73.151.138.184","1935","2","100","2","100","0","0","0.007900000","0.0181","44201.34","N/A"
"232.60.178.186","54960","216.19.0.155","80","5","280","5","280","0","0","0.007906000","0.0003","6706586.83","N/A"
"131.1.39.32","3108","81.87.82.39","80","1","52","1","52","0","0","0.007928000","0.0000","N/A","N/A"
"36.3.67.186","45692","71.215.84.2","80","1","56","1","56","0","0","0.007933000","0.0000","N/A","N/A"
"77.109.32.150","49556","148.168.217.148","80","1","56","1","56","0","0","0.007957000","0.0000","N/A","N/A"
"191.121.72.140","60627","73.151.139.236","80","1","56","1","56","0","0","0.007958000","0.0000","N/A","N/A"
"83.76.194.152","53848","201.201.131.101","31121","1","1322","1","1322","0","0","0.007991000","0.0000","N/A","N/A"
"232.35.1.210","65045","71.215.84.2","80","1","858","1","858","0","0","0.008011000","0.0000","N/A","N/A"
"219.23.236.59","49558","177.54.91.33","80","1","56","1","56","0","0","0.008012000","0.0000","N/A","N/A"
"141.145.40.110","45255","191.235.254.135","80","1","1442","0","0","1","1442","0.008026000","0.0000","N/A","N/A"
"142.89.175.174","3317","232.60.179.170","443","1","1496","0","0","1","1496","0.008051000","0.0000","N/A","N/A"
"139.143.139.18","52914","211.231.170.42","80","2","92","2","92","0","0","0.008082000","0.0012","624257.85","N/A"
"181.255.157.6","37788","181.9.98.25","25","25","37600","25","37600","0","0","0.008103000","0.0054","55223058.56","N/A"
"50.79.54.39","56533","90.119.30.8","50701","2","92","0","0","2","92","0.008132000","0.0008","N/A","905289.05"
"211.231.175.234","8777","129.241.89.163","1284","7","322","0","0","7","322","0.008132000","0.0014","N/A","1820494.70"
"83.157.98.247","1594","36.225.6.189","80","3","138","3","138","0","0","0.008147000","0.0250","44128.23","N/A"
"76.147.239.224","51452","80.96.143.161","80","2","995","2","995","0","0","0.008170000","0.0010","8040404.04","N/A"
"142.73.7.153","12067","232.60.179.232","443","1","56","0","0","1","56","0.008172000","0.0000","N/A","N/A"
"159.252.106.148","34443","181.175.235.132","80","3","3419","0","0","3","3419","0.008183000","0.0000","N/A","4558666666.67"
"150.246.18.197","41344","74.116.201.38","80","4","369","4","369","0","0","0.008205000","0.0083","356823.40","N/A"
"92.247.113.58","55943","181.175.237.236","443","3","1522","0","0","3","1522","0.008211000","0.0099","N/A","1231391.59"
"73.151.139.234","64937","64.125.233.168","443","4","5103","0","0","4","5103","0.008212000","0.0065","N/A","6246977.81"
"211.231.161.79","8081","88.166.48.50","4430","2","92","0","0","2","92","0.008231000","0.0041","N/A","177392.14"
"181.175.224.35","37789","199.174.53.50","80","1","481","1","481","0","0","0.008244000","0.0000","N/A","N/A"
"75.224.151.206","52625","243.98.113.149","80","5","7520","0","0","5","7520","0.008263000","0.0003","N/A","213333333.33"
"71.126.3.210","53441","181.175.235.117","80","3","2878","0","0","3","2878","0.008264000","0.0156","N/A","1477128.38"
"58.57.44.73","65535","80.48.205.141","59873","1","50","1","50","0","0","0.008277000","0.0000","N/A","N/A"
"43.30.193.244","35817","75.179.215.202","443","1","68","1","68","0","0","0.008306000","0.0000","N/A","N/A"
"232.35.1.226","48028","74.110.251.244","80","1","56","1","56","0","0","0.008332000","0.0000","N/A","N/A"
"141.0.1.57","55984","50.45.253.214","47415","1","56","1","56","0","0","0.008340000","0.0000","N/A","N/A"
"131.253.209.66","49766","232.60.178.253","443","1","1496","0","0","1","1496","0.008345000","0.0000","N/A","N/A"
"231.177.167.77","41091","58.57.201.3","80","1","414","1","414","0","0","0.008347000","0.0000","N/A","N/A"
"179.44.54.252","26275","50.3.145.217","80","2","92","0","0","2","92","0.008378000","0.0000","N/A","105142857.14"
"43.173.250.226","40844","211.200.14.229","443","2","858","2","858","0","0","0.008378000","0.0005","14857142.86","N/A"
"130.223.197.38","52632","211.231.161.79","8081","34","1574","34","1574","0","0","0.008383000","0.0078","1604485.22","N/A"
"191.235.250.209","33254","191.235.251.124","80","2","557","2","557","0","0","0.008385000","0.0219","203016.08","N/A"
"176.226.44.0","49929","81.197.126.31","80","1","196","0","0","1","196","0.008385000","0.0000","N/A","N/A"
"43.173.249.255","62275","92.185.170.149","80","2","406","2","406","0","0","0.008393000","0.0001","58000000.00","N/A"
"232.31.17.78","34266","58.57.201.104","80","4","224","4","224","0","0","0.008394000","0.0022","819387.29","N/A"
"70.135.1.90","49370","181.175.235.102","443","2","1484","0","0","2","1484","0.008397000","0.0000","N/A","11872000000.01"
"131.242.225.70","13435","36.3.67.192","80","1","50","0","0","1","50","0.008411000","0.0000","N/A","N/A"
"218.241.126.71","61192","58.57.201.201","80","8","448","8","448","0","0","0.008411000","0.0003","10666666.67","N/A"
"43.246.227.248","4563","70.7.186.174","80","1","46","1","46","0","0","0.008434000","0.0000","N/A","N/A"
"36.3.67.204","59621","71.215.84.62","80","2","112","2","112","0","0","0.008435000","0.0000","20837209.30","N/A"
"151.182.30.80","2944","74.116.201.38","80","1","56","1","56","0","0","0.008453000","0.0000","N/A","N/A"
"129.124.170.54","64427","211.231.171.101","80","6","276","6","276","0","0","0.008459000","0.0177","124569.82","N/A"
"180.135.222.67","52715","58.57.227.91","443","2","239","0","0","2","239","0.008467000","0.0007","N/A","2879518.07"
"50.173.117.123","49754","81.156.227.33","443","2","383","0","0","2","383","0.008487000","0.0000","N/A","3064000000.00"
"131.245.230.110","28528","232.60.178.67","443","1","1444","0","0","1","1444","0.008497000","0.0000","N/A","N/A"
"132.44.139.139","60000","92.185.136.186","80","1","64","1","64","0","0","0.008501000","0.0000","N/A","N/A"
"131.249.255.231","51851","232.60.178.118","443","1","1496","0","0","1","1496","0.008504000","0.0000","N/A","N/A"
"219.211.118.14","59993","211.231.164.53","80","2","92","2","92","0","0","0.008510000","0.0073","100573.93","N/A"
"232.60.179.141","33117","58.57.101.217","80","2","112","2","112","0","0","0.008516000","0.0002","4896174.86","N/A"
"223.58.83.125","52435","73.151.138.157","1935","3","138","3","138","0","0","0.008516000","0.0166","66461.98","N/A"
"131.244.172.115","50275","232.60.178.234","443","2","2992","0","0","2","2992","0.008528000","0.0000","N/A","2393600000.00"
"142.81.3.147","10363","232.60.179.232","80","2","2888","0","0","2","2888","0.008547000","0.0025","N/A","9153724.25"
"89.6.86.239","51715","211.231.164.26","8777","9","414","9","414","0","0","0.008553000","0.0023","1454545.45","N/A"
"231.20.46.225","49797","186.237.209.153","80","3","290","0","0","3","290","0.008572000","0.0003","N/A","8197879.86"
"138.31.189.11","1846","176.205.174.33","80","1","46","1","46","0","0","0.008605000","0.0000","N/A","N/A"
"142.83.208.67","13744","232.60.178.101","443","2","2888","0","0","2","2888","0.008610000","0.0000","N/A","2100363636.36"
"71.248.19.88","53978","73.168.177.160","80","5","7520","0","0","5","7520","0.008624000","0.0003","N/A","199867109.63"
"232.57.253.145","33745","58.57.179.195","80","1","367","0","0","1","367","0.008629000","0.0000","N/A","N/A"
"232.31.17.3","62866","29.22.12.249","80","1","56","1","56","0","0","0.008633000","0.0000","N/A","N/A"
"131.244.90.161","18050","36.3.67.144","443","1","1444","0","0","1","1444","0.008656000","0.0000","N/A","N/A"
"50.22.158.2","54527","215.75.216.25","80","1","56","0","0","1","56","0.008657000","0.0000","N/A","N/A"
"135.121.204.96","62320","80.96.136.63","80","2","112","2","112","0","0","0.008669000","0.0000","N/A","N/A"
"138.24.128.87","21843","232.60.179.147","80","4","5776","0","0","4","5776","0.008683000","0.0082","N/A","5664133.37"
"90.12.235.172","57607","211.231.170.42","80","8","368","8","368","0","0","0.008690000","0.0056","521893.28","N/A"
"135.121.204.96","62322","80.96.136.63","80","2","855","2","855","0","0","0.008694000","0.0205","334245.50","N/A"
"209.2.121.144","50967","211.231.171.101","80","9","504","9","504","0","0","0.008699000","0.0278","144983.82","N/A"
"232.60.178.97","34747","71.215.84.107","80","3","168","3","168","0","0","0.008702000","0.0001","12218181.82","N/A"
"150.246.18.197","41345","74.116.201.166","80","1","46","1","46","0","0","0.008721000","0.0000","N/A","N/A"
"223.146.170.56","52407","75.179.10.116","80","2","112","2","112","0","0","0.008724000","0.0002","4167441.86","N/A"
"142.81.138.92","20014","232.60.179.235","80","15","21660","0","0","15","21660","0.008727000","0.0130","N/A","13359031.69"
"181.9.99.143","61598","191.121.72.230","80","2","112","0","0","2","112","0.008741000","0.0001","N/A","7168000.00"
"142.70.182.126","18788","232.60.179.198","80","2","2888","0","0","2","2888","0.008759000","0.0000","N/A","4620800000.00"
"154.110.10.244","18602","74.116.201.46","80","2","112","2","112","0","0","0.008766000","0.0200","44903.28","N/A"
"219.126.173.159","41991","71.126.3.213","80","1","1087","1","1087","0","0","0.008778000","0.0000","N/A","N/A"
"76.204.87.181","38922","75.179.10.109","80","1","993","1","993","0","0","0.008783000","0.0000","N/A","N/A"
"50.79.60.56","56665","73.228.140.113","8100","3","4512","0","0","3","4512","0.008794000","0.0000","N/A","1899789473.68"
"135.241.121.160","63638","81.87.82.39","80","1","56","1","56","0","0","0.008820000","0.0000","N/A","N/A"
"34.213.13.42","29483","186.237.209.131","80","1","48","0","0","1","48","0.008823000","0.0000","N/A","N/A"
"43.173.249.58","46546","80.79.119.243","80","4","184","4","184","0","0","0.008824000","0.0003","5554716.98","N/A"
"177.136.50.137","47432","58.57.100.66","80","1","1008","1","1008","0","0","0.008829000","0.0000","N/A","N/A"
"182.111.97.94","55391","92.52.238.60","12975","1","128","1","128","0","0","0.008829000","0.0000","N/A","N/A"
"131.244.172.115","50290","232.60.179.223","443","1","1496","0","0","1","1496","0.008852000","0.0000","N/A","N/A"
"92.163.79.53","34395","211.163.30.161","6667","1","50","0","0","1","50","0.008863000","0.0000","N/A","N/A"
"142.76.108.128","12943","232.60.178.231","443","2","2888","0","0","2","2888","0.008910000","0.0000","N/A","1359058823.53"
"36.106.252.42","1111","75.179.10.108","443","1","46","1","46","0","0","0.008960000","0.0000","N/A","N/A"
"36.63.135.143","50252","36.121.243.193","80","2","2602","2","2602","0","0","0.008967000","0.0000","2973714285.71","N/A"
"142.84.131.50","13146","232.60.178.90","443","1","1484","0","0","1","1484","0.008976000","0.0000","N/A","N/A"
"95.153.183.246","60170","211.231.169.234","80","1","46","1","46","0","0","0.009002000","0.0000","N/A","N/A"
"36.3.67.159","44303","71.215.84.65","80","1","56","1","56","0","0","0.009018000","0.0000","N/A","N/A"
"0.140.164.101","50066","80.82.59.143","1935","4","6016","0","0","4","6016","0.009023000","0.0000","N/A","1375085714.29"
"181.0.120.77","36031","181.175.235.116","80","11","14413","0","0","11","14413","0.009025000","0.0001","N/A","1601444444.44"
"76.56.32.27","59928","211.231.164.165","8182","9","504","9","504","0","0","0.009053000","0.0044","917406.14","N/A"
"218.37.69.236","44678","181.9.99.65","80","2","112","2","112","0","0","0.009061000","0.0000","20363636.36","N/A"
"216.42.62.174","54403","74.110.251.155","80","5","280","5","280","0","0","0.009069000","0.0004","5258215.96","N/A"
"14.17.144.76","51626","153.231.134.73","80","19","26486","0","0","19","26486","0.009075000","0.0051","N/A","41628290.77"
"72.193.120.38","46950","232.60.179.182","443","1","64","0","0","1","64","0.009110000","0.0000","N/A","N/A"
"71.126.4.61","16837","50.3.145.217","80","3","168","0","0","3","168","0.009121000","0.0000","N/A","96000000.00"
"131.240.95.175","49192","232.60.178.255","443","3","4488","0","0","3","4488","0.009138000","0.0000","N/A","1329777777.78"
"191.121.72.81","48346","71.199.4.6","80","1","998","1","998","0","0","0.009181000","0.0000","N/A","N/A"
"181.255.157.0","42806","232.17.5.89","443","9","504","9","504","0","0","0.009210000","0.0001","49170731.71","N/A"
"231.87.99.123","62400","229.19.220.27","13936","1","46","0","0","1","46","0.009215000","0.0000","N/A","N/A"
"88.195.35.4","50004","232.60.178.222","443","1","56","0","0","1","56","0.009226000","0.0000","N/A","N/A"
"191.121.73.18","38237","29.22.12.199","80","1","56","1","56","0","0","0.009234000","0.0000","N/A","N/A"
"191.121.3.15","41992","181.255.153.246","9050","1","100","0","0","1","100","0.009238000","0.0000","N/A","N/A"
"71.215.84.114","36047","181.175.235.133","80","1","56","0","0","1","56","0.009245000","0.0000","N/A","N/A"
"143.166.58.190","55305","176.205.174.41","80","1","46","1","46","0","0","0.009251000","0.0000","N/A","N/A"
"189.143.226.95","50585","181.175.235.102","443","1","56","0","0","1","56","0.009253000","0.0000","N/A","N/A"
"177.184.0.126","20980","232.29.172.94","443","2","506","2","506","0","0","0.009307000","0.0130","311648.32","N/A"
"232.23.227.11","41708","191.121.73.161","9050","1","461","0","0","1","461","0.009332000","0.0000","N/A","N/A"
"141.149.0.79","1169","191.235.245.246","80","4","5628","0","0","4","5628","0.009339000","0.0000","N/A","1552551724.14"
"232.60.179.188","35593","58.57.100.248","80","1","56","1","56","0","0","0.009341000","0.0000","N/A","N/A"
"219.126.173.143","58850","71.126.3.197","80","2","112","2","112","0","0","0.009360000","0.0007","1321533.92","N/A"
"56.201.124.174","56485","73.249.113.13","80","1","56","0","0","1","56","0.009369000","0.0000","N/A","N/A"
"71.215.84.31","48704","191.121.73.244","80","1","56","0","0","1","56","0.009397000","0.0000","N/A","N/A"
"92.82.42.202","65130","90.204.65.34","9090","1","46","0","0","1","46","0.009409000","0.0000","N/A","N/A"
"58.57.179.207","40202","181.175.242.244","80","2","1112","2","1112","0","0","0.009411000","0.0006","14075949.37","N/A"
"138.82.148.102","45171","181.9.99.65","80","1","950","1","950","0","0","0.009423000","0.0000","N/A","N/A"
"231.87.16.36","45602","41.46.82.81","28441","5","5708","0","0","5","5708","0.009461000","0.0015","N/A","29787345.08"
"142.91.170.93","3252","36.3.67.214","443","14","17410","0","0","14","17410","0.009477000","0.0001","N/A","1079689922.48"
"135.207.15.81","53492","211.231.171.101","80","38","2128","38","2128","0","0","0.009486000","0.0041","4193103.45","N/A"
"43.214.248.195","54868","211.231.175.213","80","1","46","1","46","0","0","0.009489000","0.0000","N/A","N/A"
"137.245.106.196","60497","211.231.169.234","80","3","138","3","138","0","0","0.009537000","0.0006","1913344.89","N/A"
"58.57.201.207","39200","50.3.145.217","443","7","8393","0","0","7","8393","0.009558000","0.0001","N/A","1157655172.41"
"142.89.34.71","49424","36.3.67.167","443","1","326","0","0","1","326","0.009577000","0.0000","N/A","N/A"
"229.120.106.71","57012","36.225.33.122","8080","2","112","2","112","0","0","0.009587000","0.0200","44833.63","N/A"
"181.9.99.36","43302","232.46.190.81","443","1","654","0","0","1","654","0.009592000","0.0000","N/A","N/A"
"215.74.154.217","47971","92.238.90.87","3000","1","64","1","64","0","0","0.009597000","0.0000","N/A","N/A"
"148.168.211.243","41766","71.212.187.118","80","8","12032","0","0","8","12032","0.009603000","0.0008","N/A","124845654.99"
"253.176.80.171","50840","50.19.254.133","8080","2","92","2","92","0","0","0.009609000","0.0201","36688.10","N/A"
"88.195.47.0","38688","232.60.179.163","80","1","64","0","0","1","64","0.009617000","0.0000","N/A","N/A"
"71.126.4.235","22591","181.175.230.104","80","5","1127","0","0","5","1127","0.009628000","0.0210","N/A","429394.68"
"216.19.0.133","54251","181.175.235.118","80","1","56","0","0","1","56","0.009647000","0.0000","N/A","N/A"
"43.239.253.127","4073","211.231.161.42","80","30","1680","30","1680","0","0","0.009665000","0.0267","502617.80","N/A"
"43.30.193.244","35818","75.179.215.202","443","1","68","1","68","0","0","0.009712000","0.0000","N/A","N/A"
"132.155.80.14","60109","81.87.87.205","80","1","68","1","68","0","0","0.009727000","0.0000","N/A","N/A"
"36.3.67.174","62653","216.19.0.188","80","3","168","3","168","0","0","0.009772000","0.0001","20676923.08","N/A"
"55.146.158.120","3905","176.205.189.53","80","1","46","1","46","0","0","0.009797000","0.0000","N/A","N/A"
"138.31.249.88","33541","14.167.111.225","443","1","46","1","46","0","0","0.009815000","0.0000","N/A","N/A"
"216.9.124.141","46187","58.57.201.161","443","1","56","1","56","0","0","0.009839000","0.0000","N/A","N/A"
"74.110.251.232","49921","181.175.235.117","80","8","11119","0","0","8","11119","0.009859000","0.0000","N/A","1892595744.68"
"138.25.182.30","2017","176.205.189.82","80","2","92","2","92","0","0","0.009872000","0.0011","696310.31","N/A"
"95.206.28.198","55132","211.231.164.53","80","3","138","3","138","0","0","0.009873000","0.0196","56378.31","N/A"
"137.246.131.11","56932","73.94.226.0","56455","1","404","1","404","0","0","0.009888000","0.0000","N/A","N/A"
"131.244.116.35","50660","232.60.178.117","443","1","1496","0","0","1","1496","0.009901000","0.0000","N/A","N/A"
"215.74.154.217","57526","92.238.90.107","2608","1","64","1","64","0","0","0.009917000","0.0000","N/A","N/A"
"75.224.151.235","48703","243.98.113.151","80","3","4045","0","0","3","4045","0.009947000","0.0001","N/A","497846153.85"
"50.46.21.156","57616","232.60.178.231","443","1","56","0","0","1","56","0.009948000","0.0000","N/A","N/A"
"130.135.108.14","49769","176.205.174.34","80","2","92","2","92","0","0","0.009997000","0.0016","467895.74","N/A"
"49.117.201.220","54673","50.172.118.172","23234","1","56","1","56","0","0","0.009997000","0.0000","N/A","N/A"
"229.178.70.114","49959","211.231.170.42","80","10","460","10","460","0","0","0.010013000","0.0224","164139.16","N/A"
"177.136.50.137","58029","58.57.100.66","80","1","1024","1","1024","0","0","0.010017000","0.0000","N/A","N/A"
"90.208.14.210","1582","74.116.201.17","80","1","56","1","56","0","0","0.010075000","0.0000","N/A","N/A"
"138.25.191.167","1137","73.151.139.186","80","1","465","1","465","0","0","0.010094000","0.0000","N/A","N/A"
"129.242.135.110","31478","181.168.132.250","8080","1","56","1","56","0","0","0.010104000","0.0000","N/A","N/A"
"70.135.1.22","4219","80.82.57.125","1935","5","6805","0","0","5","6805","0.010107000","0.0000","N/A","1266046511.63"
"56.159.183.192","57046","75.226.244.225","80","1","56","1","56","0","0","0.010121000","0.0000","N/A","N/A"
"232.60.177.186","60713","75.224.151.173","80","1","739","1","739","0","0","0.010165000","0.0000","N/A","N/A"
"132.42.42.99","62612","58.57.201.65","80","1","1321","1","1321","0","0","0.010178000","0.0000","N/A","N/A"
"74.116.200.109","39610","74.116.213.103","443","3","732","0","0","3","732","0.010184000","0.0052","N/A","1136645.96"
"25.96.208.181","51195","211.231.164.218","8182","2","92","2","92","0","0","0.010193000","0.0012","627986.35","N/A"
"138.24.111.166","40800","232.60.178.101","443","10","13437","0","0","10","13437","0.010201000","0.0001","N/A","1131536842.11"
"80.45.54.117","33139","232.60.130.210","80","1","64","0","0","1","64","0.010225000","0.0000","N/A","N/A"
"181.175.230.63","62525","199.174.53.50","80","1","485","1","485","0","0","0.010245000","0.0000","N/A","N/A"
"131.243.247.194","62147","232.60.178.100","80","1","1409","0","0","1","1409","0.010256000","0.0000","N/A","N/A"
"142.89.244.30","49954","232.60.178.228","443","1","97","0","0","1","97","0.010294000","0.0000","N/A","N/A"
"135.241.225.113","54015","211.231.164.53","80","3","138","3","138","0","0","0.010310000","0.0017","631578.95","N/A"
"49.116.1.110","1968","73.151.139.180","443","1","68","1","68","0","0","0.010326000","0.0000","N/A","N/A"
"128.128.206.116","3555","192.246.188.152","445","1","52","1","52","0","0","0.010336000","0.0000","N/A","N/A"
"181.9.98.43","59797","232.46.190.81","443","4","4593","0","0","4","4593","0.010343000","0.0219","N/A","1675895.10"
"138.224.225.42","53178","50.19.161.194","8080","4","224","4","224","0","0","0.010352000","0.0000","1792000000.00","N/A"
"232.23.227.27","39092","6.168.23.28","9050","1","100","0","0","1","100","0.010402000","0.0000","N/A","N/A"
"138.82.148.69","37418","71.126.3.218","80","3","168","3","168","0","0","0.010445000","0.0001","10181818.18","N/A"
"71.215.84.71","35137","58.57.154.162","80","7","10528","0","0","7","10528","0.010461000","0.0001","N/A","915478260.87"
"43.30.166.244","4200","92.185.132.159","443","3","633","3","633","0","0","0.010489000","0.0094","538379.76","N/A"
"232.31.17.197","63011","216.19.1.101","80","1","1042","1","1042","0","0","0.010506000","0.0000","N/A","N/A"
"19.183.214.168","1163","215.75.128.202","443","1","647","0","0","1","647","0.010519000","0.0000","N/A","N/A"
"222.6.126.96","44848","29.22.12.214","80","2","112","2","112","0","0","0.010546000","0.0000","21853658.54","N/A"
"138.82.149.140","61343","36.3.136.15","80","1","56","1","56","0","0","0.010582000","0.0000","N/A","N/A"
"219.220.97.129","51883","211.231.164.53","80","4","184","4","184","0","0","0.010588000","0.0249","59125.96","N/A"
"191.121.72.83","52563","58.57.201.73","80","1","1059","1","1059","0","0","0.010639000","0.0000","N/A","N/A"
"133.203.22.0","53382","181.9.99.104","443","3","168","3","168","0","0","0.010641000","0.0006","2199672.67","N/A"
"141.26.36.145","53063","71.85.125.234","80","11","506","11","506","0","0","0.010650000","0.0260","155806.17","N/A"
"191.121.3.62","35289","218.37.69.158","9050","1","56","0","0","1","56","0.010652000","0.0000","N/A","N/A"
"58.57.201.112","46187","181.175.233.23","80","3","4325","0","0","3","4325","0.010655000","0.0000","N/A","6920000000.00"
"218.204.251.90","51461","181.168.178.26","8080","3","138","3","138","0","0","0.010656000","0.0244","45242.19","N/A"
"132.42.42.66","61188","232.30.102.57","80","5","280","5","280","0","0","0.010668000","0.0031","726094.00","N/A"
"229.134.227.35","3358","176.205.189.53","80","1","46","1","46","0","0","0.010734000","0.0000","N/A","N/A"
"191.243.246.10","60137","211.231.118.189","80","4","6016","0","0","4","6016","0.010763000","0.0155","N/A","3108441.52"
"43.30.154.68","62893","75.179.215.202","443","1","525","1","525","0","0","0.010780000","0.0000","N/A","N/A"
"232.23.227.26","47611","36.63.199.91","9050","1","100","0","0","1","100","0.010781000","0.0000","N/A","N/A"
"29.22.12.206","59477","181.175.235.118","80","3","3052","0","0","3","3052","0.010785000","0.0068","N/A","3590060.29"
"50.19.133.98","8080","77.82.250.90","4588","1","46","0","0","1","46","0.010786000","0.0000","N/A","N/A"
"43.202.131.208","63484","211.231.161.79","8081","2","92","2","92","0","0","0.010788000","0.0093","78809.29","N/A"
"181.0.120.115","65007","181.175.235.116","80","13","17943","0","0","13","17943","0.010798000","0.0001","N/A","1913920000.00"
"136.239.25.195","60310","36.225.139.101","8080","3","138","3","138","0","0","0.010799000","0.0172","64115.22","N/A"
"141.219.206.9","52823","176.205.174.34","80","1","46","1","46","0","0","0.010819000","0.0000","N/A","N/A"
"232.60.177.223","65204","75.224.151.237","80","1","56","1","56","0","0","0.010829000","0.0000","N/A","N/A"
"232.56.226.18","60849","58.57.179.188","80","1","56","0","0","1","56","0.010830000","0.0000","N/A","N/A"
"142.89.240.9","33750","36.3.67.190","443","1","1496","0","0","1","1496","0.010853000","0.0000","N/A","N/A"
"92.238.91.238","59137","74.116.213.190","443","3","732","0","0","3","732","0.010864000","0.0061","N/A","953745.93"
"71.126.28.60","62771","181.175.233.23","80","2","2571","0","0","2","2571","0.010870000","0.0000","N/A","2938285714.29"
"138.82.148.108","38177","71.199.4.6","80","1","56","1","56","0","0","0.010878000","0.0000","N/A","N/A"
"36.196.245.117","8073","73.228.135.230","80","5","7520","0","0","5","7520","0.010881000","0.0000","N/A","1307826086.96"
"130.115.167.231","2471","74.116.201.121","80","1","56","1","56","0","0","0.010886000","0.0000","N/A","N/A"
"232.2.206.241","49482","148.162.208.5","80","7","10293","0","0","7","10293","0.010905000","0.0001","N/A","1176342857.14"
"211.188.105.176","54951","224.243.43.128","443","2","141","2","141","0","0","0.010938000","0.0017","682808.72","N/A"
"142.89.59.22","18125","36.3.67.164","443","1","56","0","0","1","56","0.010973000","0.0000","N/A","N/A"
"142.70.187.94","55336","232.60.178.255","443","1","1496","0","0","1","1496","0.010978000","0.0000","N/A","N/A"
"135.229.124.239","25203","177.54.88.198","80","1","56","1","56","0","0","0.010981000","0.0000","N/A","N/A"
"41.83.169.17","34706","73.168.177.160","80","2","1938","0","0","2","1938","0.011023000","0.0000","N/A","15503999999.98"
"92.163.79.53","34383","211.163.30.161","6667","1","50","0","0","1","50","0.011025000","0.0000","N/A","N/A"
"229.122.197.30","4317","36.225.197.138","80","1","46","1","46","0","0","0.011025000","0.0000","N/A","N/A"
"218.55.82.36","3753","211.231.164.53","80","1","46","1","46","0","0","0.011066000","0.0000","N/A","N/A"
"43.173.249.115","47826","159.183.64.140","80","4","184","4","184","0","0","0.011074000","0.0002","8269662.92","N/A"
"41.141.81.212","54185","81.245.248.180","9418","1","56","1","56","0","0","0.011106000","0.0000","N/A","N/A"
"71.215.84.78","41386","181.175.233.23","80","67","94431","0","0","67","94431","0.011114000","0.0004","N/A","1690040268.46"
"181.255.157.19","57203","50.52.148.149","443","1","50","1","50","0","0","0.011131000","0.0000","N/A","N/A"
"77.110.144.37","5839","73.151.139.186","443","1","46","1","46","0","0","0.011139000","0.0000","N/A","N/A"
"0.140.137.226","60966","73.228.135.120","80","1","56","0","0","1","56","0.011151000","0.0000","N/A","N/A"
"140.201.227.208","18029","192.233.44.61","445","1","56","1","56","0","0","0.011201000","0.0000","N/A","N/A"
"55.152.24.105","34166","211.231.161.149","182","3","204","3","204","0","0","0.011222000","0.0001","13377049.18","N/A"
"131.245.109.84","13604","36.3.67.225","80","1","56","0","0","1","56","0.011230000","0.0000","N/A","N/A"
"148.161.198.165","41700","73.168.180.142","80","7","10528","0","0","7","10528","0.011241000","0.0022","N/A","38902540.42"
"181.0.120.114","46912","181.175.233.23","80","1","56","0","0","1","56","0.011246000","0.0000","N/A","N/A"
"189.143.226.93","62590","215.75.0.186","80","2","402","0","0","2","402","0.011257000","0.0000","N/A","3216000000.00"
"140.212.6.173","4824","75.179.18.192","80","1","56","1","56","0","0","0.011322000","0.0000","N/A","N/A"
"29.22.7.32","7103","141.145.36.139","1845","1","46","0","0","1","46","0.011328000","0.0000","N/A","N/A"
"88.155.74.202","20006","181.48.217.130","443","2","92","2","92","0","0","0.011348000","0.0027","273911.43","N/A"
"39.106.88.213","53636","182.97.89.57","20006","12","17069","0","0","12","17069","0.011364000","0.0256","N/A","5340529.55"
"141.146.16.205","63069","36.3.67.218","443","1","1484","0","0","1","1484","0.011377000","0.0000","N/A","N/A"
"138.28.196.135","21743","58.57.200.97","443","1","46","1","46","0","0","0.011403000","0.0000","N/A","N/A"
"88.195.43.216","58439","36.3.67.201","443","3","4488","0","0","3","4488","0.011410000","0.0000","N/A","1795200000.00"
"191.121.72.81","47452","71.199.4.6","80","3","168","3","168","0","0","0.011415000","0.0001","23578947.37","N/A"
"159.203.104.74","54518","92.52.238.166","80","1","46","1","46","0","0","0.011416000","0.0000","N/A","N/A"
"130.19.244.91","61683","211.231.170.42","80","3","138","3","138","0","0","0.011423000","0.0037","301969.37","N/A"
"71.126.4.220","20453","181.175.231.233","80","3","168","0","0","3","168","0.011433000","0.0001","N/A","19200000.00"
"43.30.154.181","58363","58.57.200.97","443","1","56","1","56","0","0","0.011458000","0.0000","N/A","N/A"
"36.0.222.232","52016","232.31.17.15","9050","1","100","0","0","1","100","0.011477000","0.0000","N/A","N/A"
"232.60.178.249","62993","216.19.1.104","80","2","112","2","112","0","0","0.011492000","0.0008","1121401.75","N/A"
"43.173.250.19","27464","148.190.39.18","80","6","276","6","276","0","0","0.011492000","0.0003","7099678.46","N/A"
"140.251.209.181","56759","211.231.170.42","80","5","230","5","230","0","0","0.011503000","0.0008","2222222.22","N/A"
"91.145.76.140","3737","211.231.161.181","80","1","46","1","46","0","0","0.011534000","0.0000","N/A","N/A"
"28.34.28.48","60088","49.119.43.82","51961","1","46","0","0","1","46","0.011543000","0.0000","N/A","N/A"
"72.157.218.218","51670","211.188.19.162","443","1","56","0","0","1","56","0.011544000","0.0000","N/A","N/A"
"142.91.170.246","54472","232.60.177.169","80","1","1381","0","0","1","1381","0.011547000","0.0000","N/A","N/A"
"131.253.173.91","11795","232.60.178.215","80","3","4332","0","0","3","4332","0.011549000","0.0000","N/A","1506782608.70"
"131.249.250.17","12028","36.3.67.203","80","3","4332","0","0","3","4332","0.011577000","0.0078","N/A","4414777.07"
"70.135.1.21","59215","215.121.230.8","80","2","402","0","0","2","402","0.011615000","0.0000","N/A","N/A"
"71.126.28.82","47442","50.3.145.217","80","1","56","0","0","1","56","0.011658000","0.0000","N/A","N/A"
"71.181.245.171","50551","92.52.238.178","443","1","56","1","56","0","0","0.011666000","0.0000","N/A","N/A"
"218.183.40.180","64042","51.67.112.131","445","1","224","1","224","0","0","0.011701000","0.0000","N/A","N/A"
"71.126.4.234","62816","73.228.141.111","80","1","64","0","0","1","64","0.011703000","0.0000","N/A","N/A"
"131.107.236.132","27323","80.96.143.161","80","1","56","1","56","0","0","0.011711000","0.0000","N/A","N/A"
"216.42.62.115","60451","29.22.12.232","80","1","975","1","975","0","0","0.011717000","0.0000","N/A","N/A"
"141.145.46.95","2312","176.205.174.33","80","2","92","2","92","0","0","0.011724000","0.0004","1703703.70","N/A"
"232.23.227.31","62787","6.168.23.56","9050","1","100","0","0","1","100","0.011738000","0.0000","N/A","N/A"
"73.151.139.189","58226","58.57.179.218","80","1","1389","0","0","1","1389","0.011761000","0.0000","N/A","N/A"
"141.148.61.206","21654","179.129.255.213","25","2","2888","2","2888","0","0","0.011780000","0.0204","1129945.71","N/A"
"177.220.92.250","58623","89.226.21.67","55523","2","153","0","0","2","153","0.011798000","0.0002","N/A","6120000.00"
"131.253.245.39","24298","36.3.67.215","443","1","1444","0","0","1","1444","0.011857000","0.0000","N/A","N/A"
"128.129.1.128","2988","70.7.191.81","80","1","46","1","46","0","0","0.011859000","0.0000","N/A","N/A"
"131.240.51.195","4318","232.60.179.232","80","2","2992","0","0","2","2992","0.011871000","0.0000","N/A","1408000000.00"
"75.226.129.172","40137","74.110.251.215","80","4","224","4","224","0","0","0.011899000","0.0001","12531468.53","N/A"
"90.197.246.158","61574","211.231.171.101","80","2","92","2","92","0","0","0.011906000","0.0139","52865.97","N/A"
"182.43.39.45","56466","222.133.102.163","50443","1","261","0","0","1","261","0.011907000","0.0000","N/A","N/A"
"231.166.142.204","64481","83.31.146.113","80","1","46","0","0","1","46","0.011923000","0.0000","N/A","N/A"
"140.250.229.15","52260","211.231.169.234","80","7","322","7","322","0","0","0.011931000","0.0038","679504.09","N/A"
"71.248.19.83","32937","73.168.180.142","80","2","2257","0","0","2","2257","0.011973000","0.0000","N/A","9028000000.00"
"49.113.179.243","4833","58.57.200.86","80","2","92","2","92","0","0","0.011984000","0.0221","33359.02","N/A"
"133.203.23.197","43641","29.22.12.198","80","2","112","2","112","0","0","0.011992000","0.0000","149333333.33","N/A"
"191.121.72.204","33580","14.167.111.137","80","3","168","3","168","0","0","0.012007000","0.0001","16000000.00","N/A"
"58.57.201.152","40363","181.175.235.116","80","61","86167","0","0","61","86167","0.012019000","0.0005","N/A","1511701754.39"
"232.60.179.178","56312","58.57.100.232","80","1","56","1","56","0","0","0.012020000","0.0000","N/A","N/A"
"232.31.17.93","64616","29.22.12.247","80","1","1082","1","1082","0","0","0.012035000","0.0000","N/A","N/A"
"211.188.158.133","38747","75.179.10.102","443","4","550","4","550","0","0","0.012050000","0.0147","299441.95","N/A"
"131.243.111.98","13328","232.60.179.233","443","1","56","0","0","1","56","0.012067000","0.0000","N/A","N/A"
"58.57.201.154","64742","181.175.235.132","80","1","56","0","0","1","56","0.012087000","0.0000","N/A","N/A"
"209.126.140.2","57828","176.205.174.33","80","1","56","1","56","0","0","0.012123000","0.0000","N/A","N/A"
"89.225.126.8","55800","211.231.164.218","8182","12","552","12","552","0","0","0.012143000","0.0091","486665.20","N/A"
"131.240.85.190","31223","232.60.179.169","80","1","1476","0","0","1","1476","0.012147000","0.0000","N/A","N/A"
"142.91.188.57","1415","232.60.178.110","80","5","7480","0","0","5","7480","0.012152000","0.0101","N/A","5899635.22"
"75.224.151.204","37704","73.168.177.160","80","1","50","0","0","1","50","0.012166000","0.0000","N/A","N/A"
"71.126.28.248","40933","181.175.233.22","80","1","56","0","0","1","56","0.012191000","0.0000","N/A","N/A"
"142.84.45.232","49422","232.60.178.254","80","1","1496","0","0","1","1496","0.012195000","0.0000","N/A","N/A"
"232.60.179.191","46603","58.57.201.162","80","1","1102","1","1102","0","0","0.012198000","0.0000","N/A","N/A"
"151.251.54.189","62661","211.231.169.234","80","24","1344","24","1344","0","0","0.012200000","0.0030","3580419.58","N/A"
"147.159.229.65","60748","50.19.133.98","80","2","92","2","92","0","0","0.012215000","0.0000","73600000.00","N/A"
"142.91.179.147","27476","36.3.67.153","80","1","1444","0","0","1","1444","0.012231000","0.0000","N/A","N/A"
"75.224.151.168","50242","181.175.235.132","80","1","335","0","0","1","335","0.012254000","0.0000","N/A","N/A"
"94.240.9.229","50049","211.231.171.101","80","21","1176","21","1176","0","0","0.012273000","0.0153","614379.94","N/A"
"232.56.227.26","45536","58.57.179.181","80","2","2629","0","0","2","2629","0.012274000","0.0000","N/A","2629000000.00"
"132.34.182.11","50156","211.231.171.101","80","9","444","9","444","0","0","0.012289000","0.0011","3243835.62","N/A"
"43.30.159.207","3926","75.179.215.229","443","1","46","1","46","0","0","0.012292000","0.0000","N/A","N/A"
"77.204.143.71","33765","81.134.50.197","25","1","56","1","56","0","0","0.012299000","0.0000","N/A","N/A"
"36.3.67.184","47519","181.0.183.118","80","1","964","1","964","0","0","0.012318000","0.0000","N/A","N/A"
"58.57.201.204","54892","181.175.234.23","80","1","56","0","0","1","56","0.012348000","0.0000","N/A","N/A"
"71.248.19.69","55793","73.168.177.160","80","8","12032","0","0","8","12032","0.012363000","0.0018","N/A","54877993.16"
"138.29.67.213","10157","58.57.200.97","443","5","240","5","240","0","0","0.012367000","0.0192","99838.80","N/A"
"142.197.210.28","2746","50.19.254.133","80","3","138","3","138","0","0","0.012392000","0.0232","47530.89","N/A"
"76.150.157.0","43145","71.85.125.149","80","1","56","1","56","0","0","0.012417000","0.0000","N/A","N/A"
"76.220.202.120","18560","176.205.141.126","80","1","52","1","52","0","0","0.012447000","0.0000","N/A","N/A"
"129.125.110.162","54285","211.231.169.234","80","5","230","5","230","0","0","0.012453000","0.0151","122080.68","N/A"
"70.7.191.242","38670","70.7.177.42","53","1","56","0","0","1","56","0.012458000","0.0000","N/A","N/A"
"191.80.115.89","1439","73.249.113.13","80","1","46","0","0","1","46","0.012462000","0.0000","N/A","N/A"
"138.31.168.59","4424","176.205.189.53","80","1","56","1","56","0","0","0.012468000","0.0000","N/A","N/A"
"91.158.4.58","57952","192.241.246.14","39929","1","56","1","56","0","0","0.012493000","0.0000","N/A","N/A"
"140.215.110.134","3606","211.231.170.42","80","3","138","3","138","0","0","0.012533000","0.0104","106399.38","N/A"
"243.84.40.60","50136","73.151.139.212","80","4","236","4","236","0","0","0.012538000","0.0120","157359.56","N/A"
"219.223.210.184","63735","73.235.203.2","57421","2","2916","2","2916","0","0","0.012556000","0.0038","6210862.62","N/A"
"219.118.19.114","53819","189.129.142.11","80","1","46","1","46","0","0","0.012565000","0.0000","N/A","N/A"
"58.57.201.242","41389","181.175.235.132","80","1","56","0","0","1","56","0.012566000","0.0000","N/A","N/A"
"71.85.125.128","63069","181.175.235.118","80","5","6893","0","0","5","6893","0.012573000","0.0000","N/A","3446500000.00"
"71.126.3.223","44025","181.175.235.116","80","6","8198","0","0","6","8198","0.012594000","0.0000","N/A","1366333333.33"
"43.192.203.94","54909","211.231.161.79","8081","3","168","3","168","0","0","0.012604000","0.0006","2243739.57","N/A"
"43.173.249.237","65110","36.225.85.189","80","3","138","3","138","0","0","0.012623000","0.0001","12404494.38","N/A"
"39.109.242.113","35325","181.175.225.241","80","5","6212","0","0","5","6212","0.012633000","0.0000","N/A","1419885714.29"
"159.197.185.183","63121","218.51.170.130","80","1","64","0","0","1","64","0.012653000","0.0000","N/A","N/A"
"141.149.198.9","16963","176.205.189.82","80","1","46","1","46","0","0","0.012696000","0.0000","N/A","N/A"
"181.9.99.5","64547","181.175.235.133","80","5","6648","0","0","5","6648","0.012708000","0.0000","N/A","3545600000.00"
"71.85.125.142","55266","181.175.234.23","443","1","56","0","0","1","56","0.012719000","0.0000","N/A","N/A"
"215.74.154.217","45761","92.238.90.126","1213","1","64","1","64","0","0","0.012724000","0.0000","N/A","N/A"
"136.111.145.128","22200","75.179.7.53","21023","3","215","3","215","0","0","0.012788000","0.0204","84272.42","N/A"
"92.238.90.117","65000","215.74.154.217","39383","1","64","0","0","1","64","0.012863000","0.0000","N/A","N/A"
"131.243.203.143","1445","232.60.179.160","80","6","8976","0","0","6","8976","0.012866000","0.0148","N/A","4866029.68"
"191.121.59.215","56864","159.230.122.122","11570","1","56","1","56","0","0","0.012874000","0.0000","N/A","N/A"
"43.252.36.237","55362","211.231.171.69","182","1","46","1","46","0","0","0.012881000","0.0000","N/A","N/A"
"211.120.240.67","35346","73.151.139.78","554","4","224","4","224","0","0","0.012921000","0.0162","110946.01","N/A"
"142.89.153.233","15048","232.60.178.88","80","2","2888","0","0","2","2888","0.012934000","0.0000","N/A","855703703.70"
"231.222.193.111","49792","232.60.179.56","443","1","50","0","0","1","50","0.012938000","0.0000","N/A","N/A"
"131.169.120.233","64150","181.168.230.170","8080","13","598","13","598","0","0","0.012941000","0.0121","394101.66","N/A"
"36.3.67.220","40324","71.215.84.8","80","1","1075","1","1075","0","0","0.012964000","0.0000","N/A","N/A"
"141.61.172.181","57584","81.107.111.194","1936","1","56","1","56","0","0","0.012984000","0.0000","N/A","N/A"
"231.177.167.100","62608","232.19.56.89","80","1","1272","1","1272","0","0","0.012989000","0.0000","N/A","N/A"
"140.207.7.105","47817","176.205.189.88","80","2","112","2","112","0","0","0.013004000","0.0040","222057.00","N/A"
"176.199.108.110","41981","73.168.177.160","80","3","858","0","0","3","858","0.013013000","0.0057","N/A","1194986.07"
"140.224.13.224","5191","14.167.111.134","80","2","425","2","425","0","0","0.013033000","0.0188","181246.34","N/A"
"135.251.202.69","52264","211.231.170.42","80","6","286","6","286","0","0","0.013042000","0.0023","982817.87","N/A"
"76.220.202.120","18550","176.205.141.126","80","3","138","3","138","0","0","0.013047000","0.0050","220183.49","N/A"
"137.96.33.162","1089","186.237.209.219","80","1","46","0","0","1","46","0.013065000","0.0000","N/A","N/A"
"25.186.233.237","50560","50.19.171.88","6112","1","53","1","53","0","0","0.013069000","0.0000","N/A","N/A"
"43.173.250.226","40843","176.218.185.226","80","4","184","4","184","0","0","0.013092000","0.0002","7666666.67","N/A"
"131.107.236.135","22266","14.167.111.233","443","6","276","6","276","0","0","0.013115000","0.0000","53853658.54","N/A"
"219.126.173.146","36428","58.57.201.65","80","1","1255","1","1255","0","0","0.013133000","0.0000","N/A","N/A"
"142.83.157.179","12009","36.3.67.227","80","15","21660","0","0","15","21660","0.013145000","0.0086","N/A","20043956.04"
"14.167.111.253","44778","75.74.95.129","80","8","12032","0","0","8","12032","0.013167000","0.0001","N/A","1093818181.82"
"49.110.254.127","2866","73.151.139.180","443","1","56","1","56","0","0","0.013181000","0.0000","N/A","N/A"
"39.119.157.117","11633","232.60.179.171","443","6","8664","0","0","6","8664","0.013187000","0.0133","N/A","5212212.36"
"74.110.251.225","56532","181.175.233.23","80","1","56","0","0","1","56","0.013203000","0.0000","N/A","N/A"
"232.60.178.224","40358","71.126.28.187","80","2","112","2","112","0","0","0.013216000","0.0001","10298850.57","N/A"
"75.235.56.87","47843","75.64.127.48","25","2","3008","2","3008","0","0","0.013221000","0.0001","270382022.47","N/A"
"232.67.52.99","35965","232.46.178.178","443","17","25568","0","0","17","25568","0.013240000","0.0001","N/A","1391455782.31"
"43.205.30.167","56691","80.100.57.131","443","1","46","1","46","0","0","0.013275000","0.0000","N/A","N/A"
"223.153.125.76","60221","148.163.8.197","8080","3","138","3","138","0","0","0.013285000","0.0040","275380.39","N/A"
"72.109.248.67","62210","205.194.30.231","80","6","5096","0","0","6","5096","0.013296000","0.0004","N/A","92027088.04"
"130.17.8.134","63536","211.231.175.130","182","15","690","15","690","0","0","0.013317000","0.0231","239002.42","N/A"
"95.150.88.98","51224","176.205.174.33","80","1","46","1","46","0","0","0.013322000","0.0000","N/A","N/A"
"137.231.222.218","56800","74.78.159.140","19152","1","46","1","46","0","0","0.013326000","0.0000","N/A","N/A"
"198.242.10.173","44525","181.168.248.125","8080","1","56","1","56","0","0","0.013338000","0.0000","N/A","N/A"
"132.13.189.161","51718","211.231.175.116","80","11","526","11","526","0","0","0.013342000","0.0157","267616.38","N/A"
"129.243.4.61","49842","189.129.142.66","80","1","56","1","56","0","0","0.013373000","0.0000","N/A","N/A"
"131.240.55.1","23428","232.60.177.227","443","1","56","0","0","1","56","0.013379000","0.0000","N/A","N/A"
"41.83.174.158","48369","232.60.178.117","443","1","56","0","0","1","56","0.013383000","0.0000","N/A","N/A"
"142.91.155.62","26241","232.60.178.116","443","2","2888","0","0","2","2888","0.013399000","0.0000","N/A","1359058823.53"
"94.40.105.235","62260","211.231.164.53","80","2","92","2","92","0","0","0.013400000","0.0182","40406.26","N/A"
"181.9.99.93","46855","181.175.235.117","80","7","10310","0","0","7","10310","0.013422000","0.0000","N/A","2114871794.87"
"92.15.216.220","64081","5.38.40.160","45599","2","100","0","0","2","100","0.013434000","0.0061","N/A","130463.14"
"231.100.21.134","1769","179.158.120.101","80","3","4512","0","0","3","4512","0.013449000","0.0002","N/A","145548387.10"
"39.109.242.119","53363","181.175.224.85","443","2","159","0","0","2","159","0.013462000","0.0010","N/A","1212583.41"
"159.206.169.26","52299","92.52.238.166","443","5","2048","5","2048","0","0","0.013470000","0.0183","893007.03","N/A"
"232.31.17.222","65256","74.110.251.203","80","7","392","7","392","0","0","0.013514000","0.0099","318343.32","N/A"
"191.121.72.204","63997","14.167.111.137","80","4","224","4","224","0","0","0.013526000","0.0003","5914191.42","N/A"
"148.162.201.140","28192","50.56.82.55","80","2","112","2","112","0","0","0.013563000","0.0149","60101.96","N/A"
"137.227.252.2","59411","211.231.161.181","80","7","322","7","322","0","0","0.013568000","0.0018","1457013.57","N/A"
"219.203.244.252","3426","14.167.111.134","443","3","138","3","138","0","0","0.013572000","0.0039","280203.05","N/A"
"58.57.201.113","55535","181.175.235.118","80","1","56","0","0","1","56","0.013575000","0.0000","N/A","N/A"
"82.47.164.11","6774","36.225.67.91","80","1","46","1","46","0","0","0.013578000","0.0000","N/A","N/A"
"81.68.35.8","28350","73.168.182.201","443","1","50","0","0","1","50","0.013589000","0.0000","N/A","N/A"
"43.196.65.59","62459","211.231.164.53","80","2","92","2","92","0","0","0.013608000","0.0026","281560.83","N/A"
"74.110.251.233","35437","181.175.233.23","80","1","56","0","0","1","56","0.013644000","0.0000","N/A","N/A"
"219.126.173.156","63444","71.126.3.213","80","2","2198","2","2198","0","0","0.013660000","0.0000","4396000000.00","N/A"
"222.143.101.33","3937","211.201.229.230","80","1","46","1","46","0","0","0.013670000","0.0000","N/A","N/A"
"43.248.23.202","50126","211.231.164.197","8182","8","368","8","368","0","0","0.013680000","0.0229","128474.80","N/A"
"223.146.176.6","53680","75.179.10.116","80","1","64","1","64","0","0","0.013684000","0.0000","N/A","N/A"
"81.226.55.213","35812","73.168.180.142","80","3","150","0","0","3","150","0.013693000","0.0035","N/A","346020.76"
"179.158.147.118","55910","179.231.228.110","5647","1","46","1","46","0","0","0.013693000","0.0000","N/A","N/A"
"49.113.95.213","56643","58.57.200.97","443","1","46","1","46","0","0","0.013713000","0.0000","N/A","N/A"
"138.31.185.171","1210","58.57.200.97","443","1","258","1","258","0","0","0.013734000","0.0000","N/A","N/A"
"229.131.13.100","47287","176.205.174.33","80","1","64","1","64","0","0","0.013739000","0.0000","N/A","N/A"
"50.45.246.190","60062","94.255.34.122","26161","1","56","0","0","1","56","0.013739000","0.0000","N/A","N/A"
"40.163.175.164","4358","211.231.169.234","80","14","1056","14","1056","0","0","0.013744000","0.0113","747279.96","N/A"
"151.194.55.33","26590","75.179.109.75","443","1","46","1","46","0","0","0.013769000","0.0000","N/A","N/A"
"39.109.242.116","53672","181.175.224.85","80","1","56","0","0","1","56","0.013782000","0.0000","N/A","N/A"
"142.73.7.153","12066","232.60.178.233","443","1","56","0","0","1","56","0.013782000","0.0000","N/A","N/A"
"142.91.171.236","10179","36.3.67.227","80","3","4332","0","0","3","4332","0.013810000","0.0000","N/A","1575272727.27"
"70.135.1.21","52671","73.97.14.109","1935","10","13630","0","0","10","13630","0.013816000","0.0001","N/A","1514444444.44"
"43.30.166.184","6834","75.179.215.202","443","1","68","1","68","0","0","0.013822000","0.0000","N/A","N/A"
"232.60.178.248","61492","216.19.0.247","80","1","1017","1","1017","0","0","0.013826000","0.0000","N/A","N/A"
"128.138.58.179","40023","21.247.33.233","80","1","56","1","56","0","0","0.013864000","0.0000","N/A","N/A"
"143.91.200.191","58431","231.87.27.219","50584","1","150","1","150","0","0","0.013931000","0.0000","N/A","N/A"
"232.60.177.185","41002","29.22.12.170","80","1","740","1","740","0","0","0.013955000","0.0000","N/A","N/A"
"219.126.173.159","63716","71.126.3.125","80","1","56","1","56","0","0","0.013956000","0.0000","N/A","N/A"
"142.85.35.209","13704","232.60.179.169","80","2","2888","0","0","2","2888","0.013961000","0.0000","N/A","1540266666.67"
"177.207.15.186","60110","181.175.235.102","443","1","64","0","0","1","64","0.013963000","0.0000","N/A","N/A"
"132.42.61.82","51621","159.230.122.158","443","4","224","4","224","0","0","0.013984000","0.0000","149333333.33","N/A"
"133.203.14.169","34581","75.179.35.253","80","10","460","10","460","0","0","0.014022000","0.0036","1034579.70","N/A"
"75.226.253.5","63715","181.175.235.117","80","1","56","0","0","1","56","0.014033000","0.0000","N/A","N/A"
"142.85.254.147","2957","232.60.179.181","443","2","100","0","0","2","100","0.014037000","0.0081","N/A","99267.90"
"142.89.111.244","52954","232.60.179.221","80","1","1496","0","0","1","1496","0.014047000","0.0000","N/A","N/A"
"71.248.19.108","37697","73.168.182.201","80","6","7804","0","0","6","7804","0.014057000","0.0000","N/A","7804000000.00"
"132.117.88.244","3482","211.231.161.181","80","1","46","1","46","0","0","0.014067000","0.0000","N/A","N/A"
"43.192.203.94","54992","211.231.161.79","8081","1","46","1","46","0","0","0.014069000","0.0000","N/A","N/A"
"133.203.23.249","39104","74.110.251.26","80","1","56","1","56","0","0","0.014079000","0.0000","N/A","N/A"
"141.144.226.202","49311","232.60.179.169","443","1","56","0","0","1","56","0.014080000","0.0000","N/A","N/A"
"130.25.95.185","63919","148.168.216.85","80","2","112","2","112","0","0","0.014089000","0.0145","61733.50","N/A"
"41.83.175.222","6897","232.60.178.110","443","9","11773","0","0","9","11773","0.014092000","0.0013","N/A","69973254.09"
"232.60.178.107","49501","181.0.120.1","80","5","280","5","280","0","0","0.014118000","0.0001","25454545.45","N/A"
"58.57.201.112","46178","181.175.233.23","80","4","5293","0","0","4","5293","0.014132000","0.0000","N/A","3528666666.67"
"191.121.75.179","38627","14.167.111.223","80","1","56","1","56","0","0","0.014155000","0.0000","N/A","N/A"
"188.97.55.74","1029","186.237.209.157","443","1","48","0","0","1","48","0.014163000","0.0000","N/A","N/A"
"56.159.144.78","37590","80.75.113.219","80","1","413","0","0","1","413","0.014180000","0.0000","N/A","N/A"
"70.147.29.177","45392","64.26.250.35","53","1","56","1","56","0","0","0.014183000","0.0000","N/A","N/A"
"71.248.27.181","53406","191.235.251.124","80","10","460","10","460","0","0","0.014226000","0.0001","32566371.68","N/A"
"181.0.181.168","34564","181.175.235.117","80","2","2181","0","0","2","2181","0.014247000","0.0000","N/A","17447999999.98"
"6.168.23.243","34400","71.215.84.89","80","4","224","4","224","0","0","0.014252000","0.0002","10298850.57","N/A"
"92.238.91.235","46307","74.116.213.103","443","3","732","0","0","3","732","0.014270000","0.0179","N/A","327352.00"
"232.23.227.26","51438","58.57.40.131","9050","1","56","0","0","1","56","0.014314000","0.0000","N/A","N/A"
"232.31.17.120","58780","75.226.244.175","80","1","883","1","883","0","0","0.014316000","0.0000","N/A","N/A"
"191.121.72.142","49922","58.57.201.198","80","2","112","2","112","0","0","0.014350000","0.0001","14688524.59","N/A"
"36.51.27.100","1966","73.97.113.54","1935","1","1504","0","0","1","1504","0.014368000","0.0000","N/A","N/A"
"129.124.52.198","32923","211.231.161.42","80","46","2944","46","2944","0","0","0.014369000","0.0059","4005442.18","N/A"
"43.173.249.108","43471","211.200.15.96","80","3","138","3","138","0","0","0.014406000","0.0001","7942446.04","N/A"
"131.243.36.85","1244","36.3.67.192","80","3","4488","0","0","3","4488","0.014416000","0.0000","N/A","1238068965.52"
"71.248.18.22","37960","73.168.180.142","80","13","19552","0","0","13","19552","0.014424000","0.0150","N/A","10449328.61"
"36.3.67.221","40370","181.0.183.94","80","4","224","4","224","0","0","0.014455000","0.0007","2731707.32","N/A"
"216.9.124.158","34174","29.22.12.249","80","2","112","2","112","0","0","0.014464000","0.0000","896000000.00","N/A"
"43.30.155.227","39386","75.179.215.202","443","1","259","1","259","0","0","0.014466000","0.0000","N/A","N/A"
"131.240.170.129","26318","232.60.178.110","443","5","7480","0","0","5","7480","0.014488000","0.0147","N/A","4084084.08"
"142.220.193.169","53008","21.247.33.117","80","4","184","4","184","0","0","0.014508000","0.0071","208115.37","N/A"
"181.9.99.6","42117","181.175.235.118","80","1","56","0","0","1","56","0.014517000","0.0000","N/A","N/A"
"198.244.194.62","49365","75.179.10.103","443","2","139","2","139","0","0","0.014520000","0.0005","2163424.12","N/A"
"198.244.194.62","38828","75.179.10.103","443","1","56","1","56","0","0","0.014531000","0.0000","N/A","N/A"
"76.77.186.231","51788","211.231.171.101","80","3","158","3","158","0","0","0.014531000","0.0036","350235.52","N/A"
"43.30.169.218","15958","73.151.139.186","80","1","56","1","56","0","0","0.014539000","0.0000","N/A","N/A"
"141.34.70.190","52839","211.231.170.69","80","2","92","2","92","0","0","0.014542000","0.0006","1284467.71","N/A"
"129.198.41.197","49607","50.19.209.10","8080","4","184","4","184","0","0","0.014545000","0.0040","366716.49","N/A"
"74.110.251.12","59505","181.175.235.133","80","68","96251","0","0","68","96251","0.014572000","0.0005","N/A","1506864970.65"
"41.140.243.55","45545","211.231.170.69","80","2","92","2","92","0","0","0.014576000","0.0006","1258119.66","N/A"
"58.57.201.188","36821","181.175.235.116","80","1","56","0","0","1","56","0.014593000","0.0000","N/A","N/A"
"191.121.72.45","63504","74.110.251.244","80","4","224","4","224","0","0","0.014611000","0.0001","12985507.25","N/A"
"131.17.27.209","61647","211.231.164.53","80","3","168","3","168","0","0","0.014632000","0.0192","69894.43","N/A"
"141.148.224.197","54052","232.60.178.244","443","1","56","0","0","1","56","0.014640000","0.0000","N/A","N/A"
"43.173.249.239","60255","80.79.119.243","80","2","92","2","92","0","0","0.014654000","0.0000","N/A","N/A"
"131.12.232.200","2271","148.163.34.10","80","6","276","6","276","0","0","0.014658000","0.0199","110721.09","N/A"
"177.96.217.142","62521","129.129.29.108","59045","2","216","0","0","2","216","0.014667000","0.0000","N/A","1728000000.00"
"76.168.101.209","65387","29.22.13.95","80","1","56","1","56","0","0","0.014725000","0.0000","N/A","N/A"
"222.7.164.30","49317","58.57.201.151","80","3","168","3","168","0","0","0.014746000","0.0001","14933333.33","N/A"
"180.129.146.183","19258","92.52.238.180","443","1","81","1","81","0","0","0.014761000","0.0000","N/A","N/A"
"128.108.72.153","62316","146.24.237.254","51413","1","68","1","68","0","0","0.014767000","0.0000","N/A","N/A"
"130.61.124.146","49986","232.60.177.218","80","2","2751","0","0","2","2751","0.014795000","0.0000","N/A","7336000000.00"
"43.79.123.2","50881","70.88.2.181","80","1","46","1","46","0","0","0.014817000","0.0000","N/A","N/A"
"232.60.179.239","34841","181.0.120.59","80","7","392","7","392","0","0","0.014841000","0.0152","206832.87","N/A"
"48.0.199.193","49700","149.184.92.22","1935","5","230","5","230","0","0","0.014849000","0.0099","186688.31","N/A"
"8.24.48.132","64777","176.205.174.33","80","1","64","1","64","0","0","0.014859000","0.0000","N/A","N/A"
"229.7.226.69","46993","211.231.170.69","80","14","644","14","644","0","0","0.014886000","0.0047","1101796.41","N/A"
"141.145.144.10","1081","36.3.67.144","443","9","13356","0","0","9","13356","0.014893000","0.0071","N/A","15127849.36"
"179.231.229.14","34376","179.158.147.122","5064","4","184","0","0","4","184","0.014905000","0.0012","N/A","1218543.05"
"188.241.46.126","60601","232.60.179.168","80","10","14995","0","0","10","14995","0.014943000","0.0004","N/A","287673860.91"
"142.91.126.11","50106","232.60.178.108","80","3","4212","0","0","3","4212","0.014947000","0.0084","N/A","4012861.74"
"56.159.183.198","22082","176.216.52.242","80","1","64","1","64","0","0","0.014948000","0.0000","N/A","N/A"
"148.168.211.243","27252","71.212.187.118","80","6","9024","0","0","6","9024","0.014992000","0.0000","N/A","4246588235.29"
"232.60.179.157","47526","181.0.183.124","80","3","168","3","168","0","0","0.015011000","0.0007","2024096.39","N/A"
"74.110.251.252","40528","181.175.235.118","80","9","12245","0","0","9","12245","0.015017000","0.0000","N/A","2332380952.38"
"209.126.140.2","57827","176.205.174.33","80","1","56","1","56","0","0","0.015018000","0.0000","N/A","N/A"
"232.35.1.226","51658","74.110.251.203","80","5","280","5","280","0","0","0.015050000","0.0002","9824561.40","N/A"
"49.113.179.243","4855","58.57.200.86","80","6","276","6","276","0","0","0.015067000","0.0091","242264.65","N/A"
"191.235.250.23","49680","191.235.251.125","80","12","552","12","552","0","0","0.015078000","0.0010","4385302.88","N/A"
"89.120.205.96","62807","75.179.25.227","80","1","46","1","46","0","0","0.015129000","0.0000","N/A","N/A"
"138.28.196.135","21744","58.57.200.97","443","1","46","1","46","0","0","0.015136000","0.0000","N/A","N/A"
"72.86.153.122","43649","232.21.65.92","443","18","1008","18","1008","0","0","0.015148000","0.0005","16592592.59","N/A"
"181.0.120.4","58660","181.175.235.132","80","11","15409","0","0","11","15409","0.015152000","0.0001","N/A","1956698412.70"
"135.149.29.248","37004","211.231.170.42","80","3","138","3","138","0","0","0.015185000","0.0075","146788.99","N/A"
"141.144.145.17","1444","36.3.67.192","443","1","50","0","0","1","50","0.015240000","0.0000","N/A","N/A"
"36.233.66.25","33493","232.27.5.114","80","5","280","5","280","0","0","0.015246000","0.0002","10370370.37","N/A"
"58.57.201.191","38869","181.175.235.133","80","60","84234","0","0","60","84234","0.015268000","0.0006","N/A","1126876254.18"
"148.161.199.168","36729","73.168.180.142","80","8","12032","0","0","8","12032","0.015302000","0.0013","N/A","76212193.19"
"78.232.121.106","21536","73.186.121.96","80","1","46","0","0","1","46","0.015309000","0.0000","N/A","N/A"
"94.35.149.90","55938","36.225.128.154","8080","3","168","3","168","0","0","0.015320000","0.0003","3895652.17","N/A"
"49.116.183.156","56987","0.216.93.194","52328","1","52","1","52","0","0","0.015326000","0.0000","N/A","N/A"
"181.175.231.182","36778","199.174.53.50","80","2","537","2","537","0","0","0.015329000","0.0045","954666.67","N/A"
"56.159.144.87","2120","211.188.162.48","80","1","364","0","0","1","364","0.015386000","0.0000","N/A","N/A"
"43.238.49.206","51451","211.231.170.106","80","5","230","5","230","0","0","0.015408000","0.0018","1019955.65","N/A"
"131.242.254.255","13205","232.60.178.74","80","1","56","0","0","1","56","0.015423000","0.0000","N/A","N/A"
"43.30.171.241","17075","71.85.125.202","80","1","56","1","56","0","0","0.015439000","0.0000","N/A","N/A"
"43.173.249.84","42687","157.121.239.253","80","2","92","2","92","0","0","0.015451000","0.0002","4433734.94","N/A"
"133.203.23.173","60036","232.28.134.100","80","4","3900","4","3900","0","0","0.015454000","0.0002","153694581.28","N/A"
"150.2.190.18","13409","148.60.7.157","80","1","46","1","46","0","0","0.015469000","0.0000","N/A","N/A"
"80.112.233.63","60086","50.56.70.207","80","12","552","12","552","0","0","0.015481000","0.0171","258714.63","N/A"
"131.13.107.255","52061","36.225.242.42","80","1","46","1","46","0","0","0.015534000","0.0000","N/A","N/A"
"91.106.19.237","57606","177.54.88.192","80","2","92","2","92","0","0","0.015561000","0.0012","603278.69","N/A"
"253.105.158.156","61035","50.172.147.210","1876","2","112","2","112","0","0","0.015574000","0.0183","48900.29","N/A"
"43.30.155.169","6884","14.167.111.134","443","4","194","4","194","0","0","0.015581000","0.0119","129994.14","N/A"
"58.57.248.113","64374","191.121.73.244","80","3","3205","0","0","3","3205","0.015588000","0.0000","N/A","674736842.11"
"138.25.190.165","62316","232.60.177.200","443","1","1441","0","0","1","1441","0.015644000","0.0000","N/A","N/A"
"146.24.103.82","3128","89.120.65.237","1927","1","46","0","0","1","46","0.015660000","0.0000","N/A","N/A"
"50.46.153.0","51424","232.60.178.117","80","1","56","0","0","1","56","0.015698000","0.0000","N/A","N/A"
"232.35.1.216","57111","29.22.12.249","80","1","983","1","983","0","0","0.015705000","0.0000","N/A","N/A"
"136.9.116.14","49961","211.231.171.101","80","18","828","18","828","0","0","0.015720000","0.0110","602072.35","N/A"
"75.53.163.121","49658","58.57.179.219","80","3","3348","0","0","3","3348","0.015731000","0.0000","N/A","1785600000.00"
"142.89.188.150","4338","232.60.178.90","443","1","1496","0","0","1","1496","0.015755000","0.0000","N/A","N/A"
"231.178.74.150","38785","182.125.133.226","80","1","64","1","64","0","0","0.015767000","0.0000","N/A","N/A"
"133.252.94.75","62140","73.235.158.140","2776","2","128","2","128","0","0","0.015778000","0.0026","388172.86","N/A"
"131.247.211.244","15617","232.60.177.218","443","2","1501","0","0","2","1501","0.015797000","0.0000","N/A","6003999999.99"
"95.150.88.98","51223","176.205.174.33","80","2","685","2","685","0","0","0.015816000","0.0026","2067924.53","N/A"
"131.243.252.91","15333","232.60.178.117","80","1","56","0","0","1","56","0.015819000","0.0000","N/A","N/A"
"216.42.62.157","52094","71.85.125.14","80","1","56","1","56","0","0","0.015827000","0.0000","N/A","N/A"
"232.60.177.147","48146","29.22.12.201","80","1","1016","1","1016","0","0","0.015836000","0.0000","N/A","N/A"
"39.124.85.216","53488","80.96.61.202","35337","1","82","0","0","1","82","0.015851000","0.0000","N/A","N/A"
"232.60.179.175","53512","71.126.28.169","80","3","168","3","168","0","0","0.015852000","0.0000","96000000.00","N/A"
"154.110.10.248","55021","14.167.111.134","80","1","56","1","56","0","0","0.015862000","0.0000","N/A","N/A"
"131.246.142.199","3908","232.60.178.66","80","1","1496","0","0","1","1496","0.015907000","0.0000","N/A","N/A"
"83.127.223.101","59040","211.231.170.42","80","3","148","3","148","0","0","0.015913000","0.0009","1284164.86","N/A"
"36.3.67.176","41887","71.215.84.17","80","1","1048","1","1048","0","0","0.015927000","0.0000","N/A","N/A"
"229.195.147.138","1971","36.225.199.184","80","1","46","1","46","0","0","0.015930000","0.0000","N/A","N/A"
"70.135.1.96","41624","50.3.145.217","443","1","83","0","0","1","83","0.015957000","0.0000","N/A","N/A"
"232.58.57.155","37866","58.57.201.118","80","4","224","4","224","0","0","0.015968000","0.0001","12108108.11","N/A"
"74.110.251.31","60212","181.175.235.117","80","5","6362","0","0","5","6362","0.015982000","0.0000","N/A","3393066666.67"
"130.49.7.190","57468","36.3.67.190","443","11","16456","0","0","11","16456","0.015998000","0.0101","N/A","13051254.09"
"129.243.4.61","49840","189.129.142.66","80","1","56","1","56","0","0","0.016031000","0.0000","N/A","N/A"
"41.83.174.197","22101","232.60.179.221","443","9","12996","0","0","9","12996","0.016065000","0.0099","N/A","10511373.98"
"232.60.177.228","52614","75.226.168.56","80","1","56","1","56","0","0","0.016066000","0.0000","N/A","N/A"
"36.63.198.123","64051","232.16.253.12","80","2","112","2","112","0","0","0.016067000","0.0000","N/A","N/A"
"232.31.17.2","60777","58.57.100.53","80","2","112","2","112","0","0","0.016073000","0.0000","32000000.00","N/A"
"232.60.179.178","63401","58.57.201.246","80","2","112","2","112","0","0","0.016097000","0.0139","64548.66","N/A"
"88.167.53.170","59067","231.85.53.49","54904","1","46","1","46","0","0","0.016104000","0.0000","N/A","N/A"
"71.248.19.114","38745","73.168.182.201","80","3","4512","0","0","3","4512","0.016108000","0.0000","N/A","12032000000.00"
"229.195.150.169","50021","148.163.17.21","8080","2","92","2","92","0","0","0.016111000","0.0199","37020.27","N/A"
"36.63.199.143","46455","71.126.3.235","443","1","56","1","56","0","0","0.016116000","0.0000","N/A","N/A"
"216.9.124.158","43464","29.22.12.168","80","1","951","1","951","0","0","0.016134000","0.0000","N/A","N/A"
"142.89.23.49","49840","36.3.67.168","443","1","50","0","0","1","50","0.016170000","0.0000","N/A","N/A"
"232.23.227.21","58255","181.255.156.114","9050","1","56","0","0","1","56","0.016184000","0.0000","N/A","N/A"
"77.109.36.90","50622","148.168.216.90","80","3","168","3","168","0","0","0.016212000","0.0127","105710.24","N/A"
"232.31.17.66","47420","75.226.167.216","80","1","56","1","56","0","0","0.016229000","0.0000","N/A","N/A"
"36.3.67.204","55819","71.126.28.169","80","1","56","1","56","0","0","0.016239000","0.0000","N/A","N/A"
"41.83.168.170","7282","232.60.178.222","443","2","2888","0","0","2","2888","0.016298000","0.0000","N/A","1777230769.23"
"41.35.141.10","51882","92.47.213.65","22","2","132","2","132","0","0","0.016326000","0.0000","52800000.00","N/A"
"83.40.207.112","52722","159.211.145.213","443","1","146","1","146","0","0","0.016336000","0.0000","N/A","N/A"
"148.166.26.28","50924","153.231.132.246","25","1","56","0","0","1","56","0.016364000","0.0000","N/A","N/A"
"232.31.17.110","64928","71.85.125.182","80","3","168","3","168","0","0","0.016372000","0.0000","29866666.67","N/A"
"219.209.162.17","63584","211.231.170.42","80","1","46","1","46","0","0","0.016383000","0.0000","N/A","N/A"
"179.231.229.177","34750","179.158.147.112","8443","2","1805","0","0","2","1805","0.016389000","0.0000","N/A","7220000000.01"
"142.89.45.251","13372","36.3.67.166","80","3","4332","0","0","3","4332","0.016400000","0.0000","N/A","1332923076.92"
"211.231.162.130","8080","95.35.161.145","2417","2","92","0","0","2","92","0.016408000","0.0161","N/A","45842.42"
"34.206.14.241","49516","92.186.87.116","8855","1","46","0","0","1","46","0.016415000","0.0000","N/A","N/A"
"138.82.148.108","65195","71.126.3.124","80","1","1173","1","1173","0","0","0.016425000","0.0000","N/A","N/A"
"43.173.250.234","25301","71.155.172.215","80","1","64","1","64","0","0","0.016427000","0.0000","N/A","N/A"
"71.126.28.98","38969","181.175.224.85","443","3","3268","0","0","3","3268","0.016442000","0.0001","N/A","195104477.61"
"232.60.179.157","54554","71.215.84.0","80","1","1026","1","1026","0","0","0.016445000","0.0000","N/A","N/A"
"167.73.180.47","55618","80.82.56.119","80","1","46","0","0","1","46","0.016468000","0.0000","N/A","N/A"
"12.253.77.49","59869","58.57.179.193","80","3","3586","0","0","3","3586","0.016484000","0.0000","N/A","2206769230.77"
"138.27.223.160","50189","176.205.174.33","80","2","92","2","92","0","0","0.016498000","0.0008","875148.63","N/A"
"75.226.253.196","42992","181.175.235.117","80","1","56","0","0","1","56","0.016549000","0.0000","N/A","N/A"
"154.56.93.86","2157","36.3.67.189","443","2","3008","0","0","2","3008","0.016571000","0.0000","N/A","1604266666.67"
"222.94.153.24","55286","211.231.161.79","8081","2","92","2","92","0","0","0.016579000","0.0020","375893.77","N/A"
"138.28.196.135","21742","58.57.200.97","443","1","46","1","46","0","0","0.016580000","0.0000","N/A","N/A"
"153.57.146.9","39711","36.3.67.144","443","11","15664","0","0","11","15664","0.016585000","0.0001","N/A","841020134.23"
"131.245.173.223","51235","232.60.179.235","80","1","1496","0","0","1","1496","0.016590000","0.0000","N/A","N/A"
"43.173.249.255","62275","80.79.119.127","80","2","333","2","333","0","0","0.016633000","0.0001","21836065.57","N/A"
"191.121.72.78","59231","73.151.139.236","80","3","168","3","168","0","0","0.016639000","0.0001","13855670.10","N/A"
"137.88.24.203","36129","177.54.82.42","80","1","56","1","56","0","0","0.016646000","0.0000","N/A","N/A"
"138.243.250.225","39485","70.7.191.81","80","2","92","2","92","0","0","0.016670000","0.0201","36584.15","N/A"
"41.140.74.138","41776","211.231.170.42","80","10","460","10","460","0","0","0.016674000","0.0185","198961.94","N/A"
"71.126.3.206","40887","181.175.235.117","80","1","56","0","0","1","56","0.016689000","0.0000","N/A","N/A"
"39.109.242.113","36862","181.175.224.85","443","1","56","0","0","1","56","0.016714000","0.0000","N/A","N/A"
"20.213.127.109","50409","36.3.67.218","443","3","205","0","0","3","205","0.016729000","0.0006","N/A","2679738.56"
"141.148.8.61","13900","176.205.189.53","80","1","46","1","46","0","0","0.016750000","0.0000","N/A","N/A"
"133.203.23.209","46629","74.110.251.26","80","1","917","1","917","0","0","0.016754000","0.0000","N/A","N/A"
"43.28.86.210","36651","75.179.215.202","443","2","294","2","294","0","0","0.016783000","0.0058","404471.20","N/A"
"74.110.251.234","54509","181.175.233.22","80","30","42119","0","0","30","42119","0.016792000","0.0001","N/A","2339944444.44"
"88.45.139.47","43825","74.116.201.246","80","4","184","4","184","0","0","0.016806000","0.0020","749109.41","N/A"
"49.148.158.27","51062","211.231.175.234","8777","3","150","3","150","0","0","0.016821000","0.0033","358744.39","N/A"
"140.234.105.203","49954","181.168.178.26","8080","2","92","2","92","0","0","0.016826000","0.0171","43078.72","N/A"
"188.241.150.165","41115","150.73.204.133","15403","1","227","0","0","1","227","0.016900000","0.0000","N/A","N/A"
"142.73.137.92","11233","232.60.179.232","80","2","2888","0","0","2","2888","0.016903000","0.0120","N/A","1931288.14"
"229.4.75.21","52389","176.205.174.34","80","2","448","2","448","0","0","0.016905000","0.0009","3849624.06","N/A"
"58.57.201.109","52470","50.3.145.217","443","1","56","0","0","1","56","0.016905000","0.0000","N/A","N/A"
"15.173.160.33","51544","232.29.61.0","80","2","112","2","112","0","0","0.016907000","0.0058","153714.19","N/A"
"232.60.179.151","59195","181.0.182.182","80","2","112","2","112","0","0","0.016911000","0.0000","49777777.78","N/A"
"138.31.168.49","1968","58.57.200.97","443","1","579","1","579","0","0","0.016919000","0.0000","N/A","N/A"
"133.203.14.171","61710","75.179.35.253","80","3","138","3","138","0","0","0.016920000","0.0001","12000000.00","N/A"
"189.202.122.170","63250","177.54.88.192","80","1","46","1","46","0","0","0.016936000","0.0000","N/A","N/A"
"219.219.2.199","2676","211.231.170.42","80","18","828","18","828","0","0","0.016984000","0.0192","345341.74","N/A"
"232.60.177.206","51493","29.22.12.229","80","1","56","1","56","0","0","0.016998000","0.0000","N/A","N/A"
"130.19.5.30","52533","211.231.170.42","80","4","184","4","184","0","0","0.017002000","0.0013","1137557.96","N/A"
"191.121.73.25","39008","29.22.12.249","80","2","112","2","112","0","0","0.017006000","0.0000","19478260.87","N/A"
"231.177.167.143","6076","232.19.59.150","443","1","56","1","56","0","0","0.017018000","0.0000","N/A","N/A"
"140.216.98.106","50522","211.231.171.234","8080","7","322","7","322","0","0","0.017021000","0.0024","1090601.19","N/A"
"219.126.173.158","36469","71.126.3.197","80","1","954","1","954","0","0","0.017027000","0.0000","N/A","N/A"
"128.10.133.60","65332","231.166.211.91","57530","1","922","1","922","0","0","0.017045000","0.0000","N/A","N/A"
"50.19.161.194","8080","223.144.70.202","4404","5","230","0","0","5","230","0.017052000","0.0119","N/A","154000.67"
"229.124.128.243","56948","50.19.161.202","8080","4","224","4","224","0","0","0.017088000","0.0079","226005.80","N/A"
"231.176.45.158","49186","215.75.219.40","6071","1","50","0","0","1","50","0.017125000","0.0000","N/A","N/A"
"25.186.225.253","63707","211.231.164.53","80","2","92","2","92","0","0","0.017126000","0.0006","1232830.82","N/A"
"29.22.12.160","62095","181.175.235.118","80","1","56","0","0","1","56","0.017156000","0.0000","N/A","N/A"
"232.60.178.114","54457","216.19.1.169","80","6","336","6","336","0","0","0.017159000","0.0003","10105263.16","N/A"
"131.244.0.88","26083","232.60.178.111","443","2","1792","0","0","2","1792","0.017210000","0.0000","N/A","7167999999.99"
"131.253.89.144","1345","232.60.179.232","80","9","13464","0","0","9","13464","0.017236000","0.0101","N/A","10656113.97"
"71.126.3.206","41018","181.175.235.117","80","1","56","0","0","1","56","0.017256000","0.0000","N/A","N/A"
"58.57.227.39","50587","56.118.232.68","80","6","336","6","336","0","0","0.017262000","0.0003","10259541.98","N/A"
"140.196.22.206","54942","211.231.170.42","80","6","276","6","276","0","0","0.017280000","0.0053","418261.03","N/A"
"36.225.72.250","8080","229.195.145.195","1479","1","46","0","0","1","46","0.017281000","0.0000","N/A","N/A"
"138.28.196.135","21746","58.57.200.97","443","1","46","1","46","0","0","0.017290000","0.0000","N/A","N/A"
"188.245.157.165","60701","232.60.178.230","443","2","2712","0","0","2","2712","0.017313000","0.0000","N/A","3616000000.00"
"229.127.29.139","45421","21.247.33.141","8004","2","112","2","112","0","0","0.017315000","0.0000","81454545.45","N/A"
"75.226.244.157","40451","181.175.235.117","80","19","27385","0","0","19","27385","0.017325000","0.0002","N/A","1404358974.36"
"142.85.208.24","27609","232.60.178.116","80","2","2888","0","0","2","2888","0.017332000","0.0011","N/A","20320140.72"
"142.83.13.169","16476","232.60.179.145","443","1","1444","0","0","1","1444","0.017334000","0.0000","N/A","N/A"
"41.83.176.255","9941","36.3.67.194","443","1","56","0","0","1","56","0.017336000","0.0000","N/A","N/A"
"56.159.183.227","47520","92.185.237.81","80","1","56","1","56","0","0","0.017355000","0.0000","N/A","N/A"
"179.23.112.124","17517","71.71.101.138","443","1","46","0","0","1","46","0.017390000","0.0000","N/A","N/A"
"146.24.247.34","18497","83.224.253.65","25","2","118","0","0","2","118","0.017400000","0.0001","N/A","8353982.30"
"70.7.191.242","41779","70.7.177.74","43","4","2821","0","0","4","2821","0.017472000","0.0017","N/A","13022504.33"
"177.118.170.140","1050","75.179.10.114","80","2","457","2","457","0","0","0.017475000","0.0112","325527.56","N/A"
"43.30.144.51","27062","58.57.200.97","443","1","64","1","64","0","0","0.017476000","0.0000","N/A","N/A"
"74.110.251.12","59517","181.175.235.133","80","10","13758","0","0","10","13758","0.017484000","0.0002","N/A","544871287.13"
"71.85.125.97","41322","243.98.126.188","443","11","16258","0","0","11","16258","0.017488000","0.0005","N/A","272670859.54"
"142.81.117.90","17255","232.60.178.245","80","1","1444","0","0","1","1444","0.017503000","0.0000","N/A","N/A"
"71.126.3.207","33915","181.175.237.236","80","5","4748","0","0","5","4748","0.017512000","0.0001","N/A","446870588.24"
"138.24.96.17","4883","232.60.179.224","80","2","2424","0","0","2","2424","0.017516000","0.0023","N/A","8542731.28"
"36.103.205.98","63586","92.52.238.178","443","1","81","1","81","0","0","0.017519000","0.0000","N/A","N/A"
"94.46.62.152","52384","81.245.238.175","80","1","46","1","46","0","0","0.017525000","0.0000","N/A","N/A"
"229.182.123.170","1382","71.149.237.159","445","1","52","1","52","0","0","0.017534000","0.0000","N/A","N/A"
"141.146.2.212","56121","232.60.179.145","443","1","52","0","0","1","52","0.017534000","0.0000","N/A","N/A"
"148.169.186.5","41919","181.41.164.8","443","4","4320","0","0","4","4320","0.017538000","0.0013","N/A","25714285.71"
"143.251.47.188","1857","70.7.191.81","80","1","46","1","46","0","0","0.017550000","0.0000","N/A","N/A"
"78.211.46.184","17039","181.175.235.102","443","1","103","0","0","1","103","0.017557000","0.0000","N/A","N/A"
"82.147.246.228","64322","177.207.15.37","3389","1","46","1","46","0","0","0.017599000","0.0000","N/A","N/A"
"131.249.226.246","24752","232.60.178.90","80","2","2888","0","0","2","2888","0.017633000","0.0026","N/A","8972427.18"
"48.109.30.141","50070","58.57.179.194","80","2","1892","0","0","2","1892","0.017639000","0.0000","N/A","7567999999.99"
"25.77.231.98","49285","70.7.186.8","80","1","46","1","46","0","0","0.017646000","0.0000","N/A","N/A"
"56.159.183.201","61101","75.226.244.219","80","1","56","1","56","0","0","0.017679000","0.0000","N/A","N/A"
"218.236.139.22","49225","177.54.88.195","80","1","46","1","46","0","0","0.017686000","0.0000","N/A","N/A"
"232.60.177.198","61516","29.22.12.166","80","1","740","1","740","0","0","0.017714000","0.0000","N/A","N/A"
"43.30.159.201","6454","75.179.215.202","443","1","247","1","247","0","0","0.017717000","0.0000","N/A","N/A"
"232.23.227.14","38082","218.61.220.15","9050","1","56","0","0","1","56","0.017731000","0.0000","N/A","N/A"
"36.102.39.173","39614","92.52.238.178","80","1","46","1","46","0","0","0.017731000","0.0000","N/A","N/A"
"131.246.117.161","3445","232.60.178.255","80","2","2808","0","0","2","2808","0.017740000","0.0000","N/A","1872000000.00"
"232.60.179.248","41989","71.215.84.2","80","1","56","1","56","0","0","0.017741000","0.0000","N/A","N/A"
"223.30.250.133","55980","75.179.109.84","443","1","46","1","46","0","0","0.017760000","0.0000","N/A","N/A"
"91.254.161.190","50670","211.231.164.26","8777","2","128","2","128","0","0","0.017798000","0.0144","71116.05","N/A"
"232.60.179.128","48532","181.0.120.98","80","2","112","2","112","0","0","0.017810000","0.0001","9431578.95","N/A"
"211.130.223.117","51487","232.60.178.111","443","1","1056","0","0","1","1056","0.017820000","0.0000","N/A","N/A"
"88.45.139.47","43822","74.116.201.246","80","2","481","2","481","0","0","0.017849000","0.0000","481000000.00","N/A"
"92.249.93.66","47975","181.175.230.104","80","1","50","0","0","1","50","0.017850000","0.0000","N/A","N/A"
"135.248.252.16","56171","148.168.216.90","80","5","280","5","280","0","0","0.017865000","0.0020","1097501.22","N/A"
"142.89.13.95","2096","36.3.67.219","443","2","2992","0","0","2","2992","0.017866000","0.0024","N/A","9969179.51"
"15.173.160.225","42760","232.29.60.125","80","2","502","2","502","0","0","0.017870000","0.0001","52155844.16","N/A"
"39.41.208.82","62380","176.63.204.110","80","1","56","0","0","1","56","0.017915000","0.0000","N/A","N/A"
"95.132.195.108","3282","211.231.161.42","80","1","46","1","46","0","0","0.017923000","0.0000","N/A","N/A"
"188.109.209.31","54613","73.97.113.68","1935","1","46","0","0","1","46","0.017935000","0.0000","N/A","N/A"
"5.49.28.74","63090","89.146.159.92","5617","1","80","0","0","1","80","0.017947000","0.0000","N/A","N/A"
"3.98.143.238","31657","179.22.21.122","80","1","56","1","56","0","0","0.017953000","0.0000","N/A","N/A"
"90.215.120.117","63787","0.222.179.26","61598","1","56","1","56","0","0","0.017960000","0.0000","N/A","N/A"
"140.254.109.242","53885","211.231.170.42","80","1","46","1","46","0","0","0.017978000","0.0000","N/A","N/A"
"95.149.234.221","2212","211.231.170.117","80","1","46","1","46","0","0","0.017994000","0.0000","N/A","N/A"
"142.85.193.217","57732","232.60.178.72","80","2","2992","0","0","2","2992","0.018003000","0.0021","N/A","11295894.29"
"135.31.209.70","52725","81.87.82.38","80","2","543","2","543","0","0","0.018041000","0.0029","1492270.70","N/A"
"151.233.246.106","53794","181.168.179.85","8080","1","56","1","56","0","0","0.018052000","0.0000","N/A","N/A"
"131.244.76.99","49933","232.60.178.110","443","2","2968","0","0","2","2968","0.018058000","0.0000","N/A","1696000000.00"
"67.55.187.37","60110","58.57.154.169","80","2","1845","0","0","2","1845","0.018068000","0.0000","N/A","14759999999.99"
"215.75.130.71","50826","181.4.84.87","7001","1","56","1","56","0","0","0.018087000","0.0000","N/A","N/A"
"142.91.155.185","2633","232.60.179.181","80","1","50","0","0","1","50","0.018087000","0.0000","N/A","N/A"
"36.217.119.162","3674","71.184.191.82","1935","3","150","3","150","0","0","0.018090000","0.0120","100100.10","N/A"
"219.223.147.57","64707","211.231.170.42","80","11","506","11","506","0","0","0.018090000","0.0108","374260.36","N/A"
"142.83.182.54","1463","36.3.67.195","443","2","2808","0","0","2","2808","0.018097000","0.0000","N/A","1021090909.09"
"150.151.164.174","46981","75.179.12.84","80","1","56","1","56","0","0","0.018135000","0.0000","N/A","N/A"
"39.109.242.114","37959","181.175.224.85","443","3","168","0","0","3","168","0.018141000","0.0088","N/A","152605.88"
"36.3.67.140","48150","216.19.1.170","80","3","168","3","168","0","0","0.018148000","0.0002","7036649.21","N/A"
"141.147.142.213","4815","232.60.179.187","80","1","1484","0","0","1","1484","0.018159000","0.0000","N/A","N/A"
"153.59.217.124","4107","232.60.178.118","443","1","1504","0","0","1","1504","0.018197000","0.0000","N/A","N/A"
"142.91.167.133","3702","232.60.179.155","80","11","14901","0","0","11","14901","0.018208000","0.0025","N/A","47304761.90"
"141.66.151.165","2502","232.60.179.181","80","1","50","0","0","1","50","0.018214000","0.0000","N/A","N/A"
"142.80.224.217","42923","232.60.179.197","80","4","6016","0","0","4","6016","0.018217000","0.0005","N/A","99643892.34"
"177.141.40.101","54240","58.57.248.73","80","2","112","2","112","0","0","0.018226000","0.0049","182819.83","N/A"
"70.135.1.21","51819","50.3.145.217","443","1","50","0","0","1","50","0.018227000","0.0000","N/A","N/A"
"135.208.193.194","58940","211.231.170.42","80","8","368","8","368","0","0","0.018231000","0.0021","1393279.70","N/A"
"90.229.116.198","58451","211.231.170.53","80","2","92","2","92","0","0","0.018232000","0.0000","N/A","N/A"
"36.3.67.176","34022","74.110.251.27","80","1","985","1","985","0","0","0.018250000","0.0000","N/A","N/A"
"49.116.6.223","56476","73.151.139.149","443","2","527","2","527","0","0","0.018263000","0.0080","525358.26","N/A"
"36.225.47.154","8080","131.169.70.21","3238","4","184","0","0","4","184","0.018266000","0.0160","N/A","91782.02"
"191.121.72.140","42021","71.126.3.244","80","5","280","5","280","0","0","0.018266000","0.0006","3803056.03","N/A"
"77.108.128.20","42800","75.179.25.227","80","1","438","1","438","0","0","0.018305000","0.0000","N/A","N/A"
"141.146.93.201","61014","176.205.189.82","80","2","92","2","92","0","0","0.018324000","0.0092","80358.12","N/A"
"159.183.84.181","8080","136.239.55.148","1881","1","46","0","0","1","46","0.018326000","0.0000","N/A","N/A"
"70.135.1.23","2086","181.175.235.102","443","1","52","0","0","1","52","0.018328000","0.0000","N/A","N/A"
"232.60.178.96","42178","181.0.182.182","80","2","112","2","112","0","0","0.018336000","0.0001","11200000.00","N/A"
"131.245.181.116","50813","232.60.178.232","443","1","56","0","0","1","56","0.018344000","0.0000","N/A","N/A"
"131.243.52.221","2469","36.3.67.201","443","1","52","0","0","1","52","0.018344000","0.0000","N/A","N/A"
"83.91.38.85","57778","50.173.158.168","57243","1","46","1","46","0","0","0.018356000","0.0000","N/A","N/A"
"232.31.17.92","63519","29.22.12.168","80","2","112","2","112","0","0","0.018360000","0.0000","35840000.00","N/A"
"151.252.135.178","49975","211.231.175.234","8777","1","50","1","50","0","0","0.018369000","0.0000","N/A","N/A"
"71.126.28.69","42679","181.175.235.116","80","1","56","0","0","1","56","0.018391000","0.0000","N/A","N/A"
"132.42.61.77","36113","36.3.137.88","443","1","56","1","56","0","0","0.018402000","0.0000","N/A","N/A"
"50.3.145.184","35945","199.174.53.50","80","1","517","1","517","0","0","0.018405000","0.0000","N/A","N/A"
"131.244.168.49","4088","36.3.67.188","443","2","2992","0","0","2","2992","0.018415000","0.0000","N/A","2393600000.00"
"43.173.249.133","5327","148.166.3.69","80","7","322","7","322","0","0","0.018432000","0.0003","9576208.18","N/A"
"138.174.45.7","10745","232.60.179.138","443","1","1444","0","0","1","1444","0.018436000","0.0000","N/A","N/A"
"43.173.249.255","62275","50.52.146.42","80","2","436","2","436","0","0","0.018438000","0.0000","205176470.59","N/A"
"232.60.177.146","62563","29.22.12.229","80","1","934","1","934","0","0","0.018457000","0.0000","N/A","N/A"
"128.130.125.170","3793","178.61.249.66","3389","1","95","1","95","0","0","0.018466000","0.0000","N/A","N/A"
"43.30.26.200","45773","188.247.94.225","26113","1","56","1","56","0","0","0.018471000","0.0000","N/A","N/A"
"71.126.4.53","28087","181.175.235.102","80","1","69","0","0","1","69","0.018471000","0.0000","N/A","N/A"
"74.61.228.233","52451","215.74.33.110","443","2","250","0","0","2","250","0.018517000","0.0000","N/A","2000000000.00"
"232.32.134.124","38249","189.132.225.68","80","1","52","0","0","1","52","0.018520000","0.0000","N/A","N/A"
"133.203.23.206","65337","71.85.125.181","80","1","894","1","894","0","0","0.018541000","0.0000","N/A","N/A"
"131.243.166.56","10355","232.60.179.137","443","1","50","0","0","1","50","0.018596000","0.0000","N/A","N/A"
"232.60.176.58","42547","74.110.251.153","80","7","392","7","392","0","0","0.018630000","0.0011","2767872.90","N/A"
"131.253.186.161","13779","232.60.178.116","80","1","1444","0","0","1","1444","0.018642000","0.0000","N/A","N/A"
"188.245.167.245","45685","128.134.237.241","33790","1","46","0","0","1","46","0.018663000","0.0000","N/A","N/A"
"150.97.24.253","55175","17.137.137.219","2189","1","46","1","46","0","0","0.018679000","0.0000","N/A","N/A"
"232.60.177.198","39531","75.226.168.87","80","1","1197","1","1197","0","0","0.018705000","0.0000","N/A","N/A"
"49.113.179.243","4851","58.57.200.86","80","1","46","1","46","0","0","0.018707000","0.0000","N/A","N/A"
"95.90.114.113","51060","181.168.143.223","80","2","112","2","112","0","0","0.018738000","0.0008","1159120.31","N/A"
"232.60.178.105","48180","216.19.1.135","80","1","56","1","56","0","0","0.018740000","0.0000","N/A","N/A"
"232.60.179.243","46817","74.110.251.213","80","1","56","1","56","0","0","0.018764000","0.0000","N/A","N/A"
"94.221.232.6","54465","80.74.173.187","2242","1","66","1","66","0","0","0.018781000","0.0000","N/A","N/A"
"58.57.201.108","33880","181.175.237.236","443","1","56","0","0","1","56","0.018791000","0.0000","N/A","N/A"
"71.126.3.230","65443","181.175.235.116","80","7","10195","0","0","7","10195","0.018824000","0.0000","N/A","2718666666.67"
"36.107.185.252","49301","178.61.218.42","443","1","69","1","69","0","0","0.018834000","0.0000","N/A","N/A"
"40.169.44.173","49560","211.231.175.43","80","2","92","2","92","0","0","0.018864000","0.0000","122666666.67","N/A"
"146.24.247.34","20279","181.175.235.102","443","1","477","0","0","1","477","0.018878000","0.0000","N/A","N/A"
"129.242.135.104","55158","56.118.8.135","993","1","107","1","107","0","0","0.018878000","0.0000","N/A","N/A"
"191.121.72.46","57049","58.57.201.121","80","5","280","5","280","0","0","0.018878000","0.0002","11666666.67","N/A"
"71.215.84.96","60525","181.175.233.23","80","6","7815","0","0","6","7815","0.018932000","0.0000","N/A","4168000000.00"
"142.84.54.40","16636","232.60.179.183","443","3","4332","0","0","3","4332","0.018936000","0.0000","N/A","1650285714.29"
"148.166.16.213","57896","153.231.132.246","25","1","56","0","0","1","56","0.018937000","0.0000","N/A","N/A"
"80.74.64.135","21262","72.192.80.174","80","1","56","0","0","1","56","0.018937000","0.0000","N/A","N/A"
"71.248.19.119","50391","73.168.177.160","80","2","348","0","0","2","348","0.018939000","0.0061","N/A","459481.76"
"142.91.11.118","1764","232.60.178.75","80","2","2968","0","0","2","2968","0.018959000","0.0000","N/A","1696000000.00"
"215.74.154.217","58322","92.238.90.94","4900","1","64","1","64","0","0","0.018961000","0.0000","N/A","N/A"
"196.37.254.146","21864","58.57.200.97","80","1","56","1","56","0","0","0.018961000","0.0000","N/A","N/A"
"70.135.1.89","56340","181.175.237.236","443","9","9964","0","0","9","9964","0.018978000","0.0001","N/A","608488549.62"
"49.73.216.143","59992","36.225.122.26","8080","1","46","1","46","0","0","0.019017000","0.0000","N/A","N/A"
"71.248.19.107","57327","73.168.180.142","80","4","3143","0","0","4","3143","0.019026000","0.0004","N/A","65994750.66"
"137.233.178.255","54176","75.179.10.109","80","1","46","1","46","0","0","0.019033000","0.0000","N/A","N/A"
"51.67.102.117","3851","153.228.39.36","80","1","46","0","0","1","46","0.019042000","0.0000","N/A","N/A"
"131.245.77.190","27414","232.60.178.64","80","1","56","0","0","1","56","0.019063000","0.0000","N/A","N/A"
"142.81.74.137","51226","232.60.178.88","80","2","2992","0","0","2","2992","0.019083000","0.0025","N/A","9737998.37"
"131.247.191.93","50658","232.60.178.254","80","3","4488","0","0","3","4488","0.019090000","0.0000","N/A","1436160000.00"
"132.42.56.70","34706","92.139.192.246","80","8","448","8","448","0","0","0.019110000","0.0058","618998.27","N/A"
"232.31.17.93","40967","29.22.12.202","80","1","1236","1","1236","0","0","0.019114000","0.0000","N/A","N/A"
"159.200.156.189","49180","92.52.238.168","443","1","46","1","46","0","0","0.019118000","0.0000","N/A","N/A"
"36.233.66.24","57786","36.4.211.85","443","1","56","1","56","0","0","0.019123000","0.0000","N/A","N/A"
"80.82.59.91","1935","231.20.96.128","1462","7","8831","7","8831","0","0","0.019144000","0.0001","1197423728.81","N/A"
"71.126.4.8","49434","73.228.135.206","80","1","56","0","0","1","56","0.019192000","0.0000","N/A","N/A"
"156.164.193.41","61624","70.150.188.4","443","1","529","0","0","1","529","0.019213000","0.0000","N/A","N/A"
"43.173.249.203","54211","176.218.185.226","80","1","64","1","64","0","0","0.019214000","0.0000","N/A","N/A"
"142.89.151.130","1390","232.60.178.108","80","2","2992","0","0","2","2992","0.019253000","0.0046","N/A","5171996.54"
"48.111.175.132","1750","30.206.194.68","80","2","3008","0","0","2","3008","0.019261000","0.0004","N/A","65391304.35"
"181.131.172.64","54378","73.228.135.230","80","1","56","0","0","1","56","0.019262000","0.0000","N/A","N/A"
"50.33.161.21","51357","211.231.118.130","80","4","6016","0","0","4","6016","0.019263000","0.0000","N/A","6875428571.43"
"232.35.8.142","33623","159.211.144.75","80","1","56","1","56","0","0","0.019308000","0.0000","N/A","N/A"
"159.206.169.26","49829","92.52.238.166","443","3","221","3","221","0","0","0.019326000","0.0125","141428.69","N/A"
"180.238.40.162","38333","73.168.182.200","80","1","50","0","0","1","50","0.019329000","0.0000","N/A","N/A"
"142.83.13.204","23146","232.60.178.247","80","2","2888","0","0","2","2888","0.019338000","0.0000","N/A","2310400000.00"
"181.168.161.170","8080","219.116.250.246","2043","1","46","0","0","1","46","0.019339000","0.0000","N/A","N/A"
"43.30.193.244","35820","75.179.215.202","443","1","68","1","68","0","0","0.019380000","0.0000","N/A","N/A"
"142.89.210.248","13517","36.3.67.168","443","1","64","0","0","1","64","0.019387000","0.0000","N/A","N/A"
"82.149.242.125","53977","181.168.236.234","80","1","46","1","46","0","0","0.019389000","0.0000","N/A","N/A"
"34.217.29.72","49187","186.237.209.132","80","1","46","0","0","1","46","0.019430000","0.0000","N/A","N/A"
"232.60.179.238","33342","181.0.120.134","80","1","1119","1","1119","0","0","0.019437000","0.0000","N/A","N/A"
"232.60.179.157","61568","74.110.251.23","80","2","112","2","112","0","0","0.019452000","0.0045","198845.98","N/A"
"219.217.197.194","56493","211.231.170.106","80","9","414","9","414","0","0","0.019466000","0.0027","1239985.02","N/A"
"142.89.182.138","2865","232.60.179.187","80","4","5616","0","0","4","5616","0.019487000","0.0047","N/A","9602051.72"
"77.203.166.60","31036","75.179.109.75","443","1","46","1","46","0","0","0.019488000","0.0000","N/A","N/A"
"133.43.33.201","4587","178.73.224.78","445","1","52","1","52","0","0","0.019496000","0.0000","N/A","N/A"
"150.72.249.42","2677","232.60.178.108","80","2","2968","0","0","2","2968","0.019509000","0.0000","N/A","1978666666.67"
"142.220.193.169","53014","21.247.33.117","80","1","46","1","46","0","0","0.019515000","0.0000","N/A","N/A"
"90.195.168.0","62056","211.231.170.42","80","8","368","8","368","0","0","0.019532000","0.0174","169526.66","N/A"
"71.199.4.206","52444","243.98.126.188","443","1","56","0","0","1","56","0.019543000","0.0000","N/A","N/A"
"43.30.166.1","48452","14.167.111.134","443","1","68","1","68","0","0","0.019560000","0.0000","N/A","N/A"
"43.253.36.99","49210","159.183.123.75","80","1","46","1","46","0","0","0.019575000","0.0000","N/A","N/A"
"211.231.164.210","8182","196.59.11.169","7234","2","100","0","0","2","100","0.019588000","0.0007","N/A","1199400.30"
"232.60.178.114","63095","216.19.1.197","80","1","999","1","999","0","0","0.019593000","0.0000","N/A","N/A"
"229.132.33.73","2554","176.205.174.33","80","1","46","1","46","0","0","0.019600000","0.0000","N/A","N/A"
"180.97.36.189","35165","191.250.205.245","8640","4","184","0","0","4","184","0.019617000","0.0058","N/A","253399.90"
"71.126.3.230","49536","64.125.233.153","443","1","56","0","0","1","56","0.019643000","0.0000","N/A","N/A"
"132.42.42.109","44073","75.179.35.253","443","2","92","2","92","0","0","0.019672000","0.0013","584126.98","N/A"
"151.250.26.170","63939","211.231.161.79","8081","3","138","3","138","0","0","0.019686000","0.0017","643731.78","N/A"
"159.252.235.61","38144","74.110.251.26","80","1","1459","1","1459","0","0","0.019696000","0.0000","N/A","N/A"
"218.37.69.239","42542","71.199.4.97","80","1","1296","1","1296","0","0","0.019729000","0.0000","N/A","N/A"
"132.42.61.77","56764","36.3.137.96","443","2","757","2","757","0","0","0.019799000","0.0066","917993.03","N/A"
"131.246.149.234","50617","232.60.179.232","443","2","2992","0","0","2","2992","0.019833000","0.0000","N/A","1994666666.67"
"72.157.218.213","60482","211.188.19.162","443","2","1153","0","0","2","1153","0.019835000","0.0000","N/A","401043478.26"
"34.234.128.241","1105","186.237.209.199","80","5","7280","0","0","5","7280","0.019846000","0.0000","N/A","4480000000.00"
"142.70.2.145","12635","232.60.178.111","80","1","1444","0","0","1","1444","0.019854000","0.0000","N/A","N/A"
"0.216.38.171","60413","80.82.59.41","1935","10","12356","0","0","10","12356","0.019856000","0.0002","N/A","625620253.16"
"15.173.160.34","55865","14.167.111.183","80","2","303","2","303","0","0","0.019861000","0.0000","N/A","N/A"
"36.102.20.33","1048","92.52.238.135","443","1","46","1","46","0","0","0.019912000","0.0000","N/A","N/A"
"71.215.84.127","65359","181.175.235.118","80","1","56","0","0","1","56","0.019931000","0.0000","N/A","N/A"
"131.245.158.61","13622","36.3.67.225","80","12","16429","0","0","12","16429","0.019937000","0.0040","N/A","32792415.17"
"88.153.36.160","58092","211.231.170.42","80","9","504","9","504","0","0","0.019943000","0.0141","286119.78","N/A"
"20.213.127.109","50411","36.3.67.181","443","3","205","0","0","3","205","0.019949000","0.0004","N/A","3685393.26"
"177.96.235.185","55156","80.82.59.158","1935","14","18722","0","0","14","18722","0.019953000","0.0001","N/A","1093255474.45"
"198.244.194.62","37965","75.179.10.103","443","2","139","2","139","0","0","0.019978000","0.0004","2780000.00","N/A"
"219.126.173.134","61228","71.85.125.149","80","1","1194","1","1194","0","0","0.020013000","0.0000","N/A","N/A"
"4.3.158.139","17444","72.192.80.170","80","1","46","0","0","1","46","0.020022000","0.0000","N/A","N/A"
"196.37.214.253","3906","211.231.175.194","182","1","46","1","46","0","0","0.020035000","0.0000","N/A","N/A"
"182.35.5.17","54425","80.82.56.124","80","1","46","0","0","1","46","0.020036000","0.0000","N/A","N/A"
"95.90.114.113","51070","181.168.143.223","80","2","976","2","976","0","0","0.020051000","0.0110","710658.05","N/A"
"211.231.161.79","8081","25.107.138.154","2227","3","138","0","0","3","138","0.020067000","0.0013","N/A","878281.62"
"28.34.79.183","62222","73.228.140.113","5001","1","46","0","0","1","46","0.020072000","0.0000","N/A","N/A"
"51.66.206.97","53885","211.188.14.163","80","1","329","0","0","1","329","0.020082000","0.0000","N/A","N/A"
"92.249.93.66","30778","181.175.230.104","80","1","50","0","0","1","50","0.020096000","0.0000","N/A","N/A"
"133.33.207.221","53004","75.179.7.205","80","1","56","1","56","0","0","0.020099000","0.0000","N/A","N/A"
"94.40.22.104","53289","211.231.171.101","80","1","56","1","56","0","0","0.020100000","0.0000","N/A","N/A"
"232.60.178.115","43436","74.110.251.203","80","1","56","1","56","0","0","0.020104000","0.0000","N/A","N/A"
"133.203.14.171","39802","75.179.35.253","80","3","138","3","138","0","0","0.020119000","0.0001","11381443.30","N/A"
"181.131.167.85","49842","92.71.197.137","1935","1","56","0","0","1","56","0.020132000","0.0000","N/A","N/A"
"71.126.28.79","38510","181.175.231.233","443","13","19552","0","0","13","19552","0.020136000","0.0001","N/A","1231622047.24"
"138.28.247.137","18000","176.205.174.33","80","1","56","1","56","0","0","0.020147000","0.0000","N/A","N/A"
"154.95.15.19","23557","232.60.178.247","443","3","4338","0","0","3","4338","0.020203000","0.0000","N/A","1446000000.00"
"229.197.1.144","46874","75.179.10.103","443","1","56","1","56","0","0","0.020204000","0.0000","N/A","N/A"
"232.60.178.210","60981","58.57.201.246","80","4","224","4","224","0","0","0.020205000","0.0001","17066666.67","N/A"
"88.193.110.78","51603","36.3.67.193","443","1","50","0","0","1","50","0.020210000","0.0000","N/A","N/A"
"41.141.81.212","54208","81.245.248.180","9418","1","56","1","56","0","0","0.020216000","0.0000","N/A","N/A"
"74.110.251.19","34458","181.175.235.132","80","41","57402","0","0","41","57402","0.020223000","0.0003","N/A","1510578947.37"
"131.240.200.208","11364","232.60.178.235","443","1","1444","0","0","1","1444","0.020234000","0.0000","N/A","N/A"
"95.90.114.113","51066","181.168.143.223","80","2","136","2","136","0","0","0.020255000","0.0010","1144058.89","N/A"
"247.251.136.7","42674","177.118.15.54","80","1","46","0","0","1","46","0.020276000","0.0000","N/A","N/A"
"150.148.251.92","64547","36.225.77.31","42223","6","340","6","340","0","0","0.020291000","0.0007","3746556.47","N/A"
"71.248.19.102","44681","73.168.182.201","80","1","50","0","0","1","50","0.020302000","0.0000","N/A","N/A"
"20.213.127.109","50430","232.60.178.253","443","4","261","0","0","4","261","0.020340000","0.0002","N/A","13050000.00"
"132.42.42.84","38863","71.199.4.57","443","1","1069","1","1069","0","0","0.020354000","0.0000","N/A","N/A"
"232.35.1.239","40154","73.151.139.229","80","12","672","12","672","0","0","0.020428000","0.0007","7658119.66","N/A"
"232.23.227.6","38498","138.88.68.107","9050","1","100","0","0","1","100","0.020442000","0.0000","N/A","N/A"
"135.94.216.31","42833","81.245.255.202","80","1","56","1","56","0","0","0.020453000","0.0000","N/A","N/A"
"211.144.0.138","59223","12.254.8.217","4500","1","46","1","46","0","0","0.020453000","0.0000","N/A","N/A"
"198.242.154.152","32989","75.179.10.103","443","1","56","1","56","0","0","0.020453000","0.0000","N/A","N/A"
"232.60.179.240","35433","181.0.142.56","80","4","224","4","224","0","0","0.020460000","0.0001","13891472.87","N/A"
"76.150.157.36","56865","71.215.84.2","80","5","280","5","280","0","0","0.020465000","0.0002","12043010.75","N/A"
"181.0.183.76","55583","181.175.235.118","80","8","11217","0","0","8","11217","0.020490000","0.0000","N/A","2563885714.29"
"75.226.129.0","35587","181.0.158.26","80","1","1342","1","1342","0","0","0.020497000","0.0000","N/A","N/A"
"81.191.64.158","21376","58.57.227.83","80","4","4280","0","0","4","4280","0.020519000","0.0025","N/A","13739967.90"
"229.126.118.184","55910","36.225.173.101","8080","1","56","1","56","0","0","0.020519000","0.0000","N/A","N/A"
"181.157.152.20","49919","37.20.48.200","80","3","150","3","150","0","0","0.020531000","0.0081","149049.81","N/A"
"181.168.191.2","8080","82.110.253.172","1980","1","46","0","0","1","46","0.020542000","0.0000","N/A","N/A"
"141.148.129.9","10415","232.60.177.250","443","3","1567","0","0","3","1567","0.020555000","0.0138","N/A","907353.79"
"131.244.74.49","10141","232.60.179.139","80","1","50","0","0","1","50","0.020558000","0.0000","N/A","N/A"
"209.2.114.211","58852","211.231.170.42","80","2","92","2","92","0","0","0.020568000","0.0122","60111.07","N/A"
"232.60.179.242","42113","216.19.1.156","80","1","56","1","56","0","0","0.020579000","0.0000","N/A","N/A"
"142.89.39.11","49197","232.60.177.151","443","1","1496","0","0","1","1496","0.020593000","0.0000","N/A","N/A"
"131.242.152.60","23126","232.60.178.255","443","1","56","0","0","1","56","0.020594000","0.0000","N/A","N/A"
"231.179.245.178","50310","215.74.204.8","443","1","294","0","0","1","294","0.020597000","0.0000","N/A","N/A"
"71.126.4.48","55210","92.71.199.48","80","3","520","0","0","3","520","0.020608000","0.0028","N/A","1491039.43"
"211.188.105.176","55862","224.243.43.148","443","1","52","1","52","0","0","0.020617000","0.0000","N/A","N/A"
"131.245.94.169","23835","232.60.179.181","443","1","1444","0","0","1","1444","0.020658000","0.0000","N/A","N/A"
"36.63.199.167","53495","75.179.35.253","443","1","46","1","46","0","0","0.020674000","0.0000","N/A","N/A"
"132.42.61.85","36690","232.17.5.89","443","1","56","1","56","0","0","0.020697000","0.0000","N/A","N/A"
"71.126.4.11","25480","181.175.237.236","80","4","4244","0","0","4","4244","0.020717000","0.0006","N/A","60955116.70"
"71.248.19.79","38739","73.168.182.201","80","11","16544","0","0","11","16544","0.020724000","0.0113","N/A","11717751.22"
"58.57.179.225","56607","50.3.167.36","80","1","961","1","961","0","0","0.020736000","0.0000","N/A","N/A"
"131.243.172.124","28040","36.3.67.191","443","4","231","0","0","4","231","0.020742000","0.0021","N/A","874585.90"
"142.81.138.118","25159","232.60.178.234","443","1","1444","0","0","1","1444","0.020746000","0.0000","N/A","N/A"
"36.3.67.173","63691","181.0.142.34","80","4","224","4","224","0","0","0.020750000","0.0002","7284552.85","N/A"
"232.60.178.69","61021","58.57.201.216","80","3","168","3","168","0","0","0.020753000","0.0081","165293.32","N/A"
"215.75.116.52","36337","80.93.202.47","80","3","180","3","180","0","0","0.020761000","0.0003","5517241.38","N/A"
"232.60.179.242","50899","216.19.1.169","80","1","56","1","56","0","0","0.020767000","0.0000","N/A","N/A"
"143.251.47.188","1859","70.7.191.81","80","1","46","1","46","0","0","0.020774000","0.0000","N/A","N/A"
"58.57.227.51","63758","14.167.111.247","80","1","803","1","803","0","0","0.020794000","0.0000","N/A","N/A"
"181.255.157.1","33919","80.100.21.158","80","1","64","1","64","0","0","0.020819000","0.0000","N/A","N/A"
"140.214.203.155","51655","75.179.18.192","80","6","336","6","336","0","0","0.020827000","0.0018","1457700.65","N/A"
"50.46.146.6","53740","186.237.209.132","80","3","244","0","0","3","244","0.020835000","0.0002","N/A","9339712.92"
"131.240.203.65","13993","232.60.178.215","80","2","2888","0","0","2","2888","0.020856000","0.0051","N/A","4513381.52"
"80.100.40.33","54846","92.166.241.218","443","1","64","0","0","1","64","0.020913000","0.0000","N/A","N/A"
"153.59.208.197","53437","58.57.200.86","443","1","46","1","46","0","0","0.020982000","0.0000","N/A","N/A"
"71.215.84.94","54401","181.175.235.118","80","11","15577","0","0","11","15577","0.021047000","0.0001","N/A","1258747474.75"
"49.116.48.198","51639","73.151.139.181","443","2","92","2","92","0","0","0.021048000","0.0000","N/A","N/A"
"229.131.13.100","36722","176.205.174.33","80","1","64","1","64","0","0","0.021059000","0.0000","N/A","N/A"
"142.91.222.230","53239","36.3.67.181","80","1","56","0","0","1","56","0.021075000","0.0000","N/A","N/A"
"83.100.32.23","59060","177.54.88.192","80","2","92","2","92","0","0","0.021086000","0.0006","1170111.29","N/A"
"191.121.72.204","63998","14.167.111.137","80","3","168","3","168","0","0","0.021104000","0.0001","22400000.00","N/A"
"50.47.126.8","54237","73.177.182.12","1935","1","149","0","0","1","149","0.021110000","0.0000","N/A","N/A"
"34.217.26.107","49203","186.237.209.199","80","2","2968","0","0","2","2968","0.021113000","0.0000","N/A","7914666666.67"
"232.56.226.3","53085","58.57.179.236","80","2","2518","0","0","2","2518","0.021120000","0.0000","N/A","6714666666.67"
"232.31.17.184","51726","71.215.84.75","80","4","224","4","224","0","0","0.021124000","0.0002","7825327.51","N/A"
"43.173.249.188","36502","148.163.53.130","80","2","311","2","311","0","0","0.021138000","0.0000","77750000.00","N/A"
"133.203.22.44","62932","71.85.125.187","443","3","168","3","168","0","0","0.021144000","0.0001","14147368.42","N/A"
"131.240.139.24","13063","36.3.67.193","443","2","2972","0","0","2","2972","0.021150000","0.0000","N/A","2161454545.45"
"181.168.221.165","8080","140.234.126.152","2891","1","46","0","0","1","46","0.021156000","0.0000","N/A","N/A"
"55.146.242.29","49504","58.57.200.97","443","2","92","2","92","0","0","0.021159000","0.0000","16727272.73","N/A"
"71.126.3.206","44579","181.175.235.117","80","5","6489","0","0","5","6489","0.021163000","0.0003","N/A","204377952.76"
"39.119.155.92","49281","73.97.71.223","80","1","64","0","0","1","64","0.021201000","0.0000","N/A","N/A"
"143.167.134.151","64011","176.205.174.34","80","1","56","1","56","0","0","0.021220000","0.0000","N/A","N/A"
"232.56.227.58","39497","58.57.179.169","80","6","9024","0","0","6","9024","0.021222000","0.0001","N/A","768000000.00"
"36.225.197.138","8080","198.245.143.6","3861","1","46","0","0","1","46","0.021275000","0.0000","N/A","N/A"
"131.244.43.51","3069","232.60.179.245","80","1","50","0","0","1","50","0.021275000","0.0000","N/A","N/A"
"71.111.161.216","11321","215.74.26.171","443","1","64","0","0","1","64","0.021299000","0.0000","N/A","N/A"
"142.70.193.135","29638","232.60.178.233","443","1","1444","0","0","1","1444","0.021302000","0.0000","N/A","N/A"
"141.150.241.69","63486","36.3.67.168","443","1","1476","0","0","1","1476","0.021322000","0.0000","N/A","N/A"
"58.57.179.223","38662","50.3.163.246","80","1","1042","1","1042","0","0","0.021332000","0.0000","N/A","N/A"
"135.85.178.143","65459","50.19.195.165","13038","2","112","2","112","0","0","0.021337000","0.0099","90277.08","N/A"
"138.28.196.135","21747","58.57.200.97","443","1","46","1","46","0","0","0.021338000","0.0000","N/A","N/A"
"181.0.183.198","42410","181.175.235.132","80","8","11849","0","0","8","11849","0.021346000","0.0001","N/A","1634344827.59"
"141.144.144.13","2223","36.3.67.139","80","1","1484","0","0","1","1484","0.021398000","0.0000","N/A","N/A"
"74.110.251.243","42441","181.175.235.118","80","1","56","0","0","1","56","0.021403000","0.0000","N/A","N/A"
"43.173.249.108","43472","75.179.10.109","443","2","264","2","264","0","0","0.021405000","0.0002","13803921.57","N/A"
"75.226.253.226","38118","181.175.235.118","80","7","9723","0","0","7","9723","0.021420000","0.0001","N/A","1127304347.83"
"43.202.219.205","4529","211.231.161.181","80","2","92","2","92","0","0","0.021441000","0.0007","1113464.45","N/A"
"138.88.68.105","33652","232.17.5.89","443","1","56","1","56","0","0","0.021448000","0.0000","N/A","N/A"
"95.164.166.173","36923","58.57.201.120","80","4","224","4","224","0","0","0.021453000","0.0003","6074576.27","N/A"
"43.238.49.206","51555","211.231.170.106","80","4","184","4","184","0","0","0.021461000","0.0017","848904.27","N/A"
"142.83.6.96","29106","232.60.179.226","80","1","175","0","0","1","175","0.021477000","0.0000","N/A","N/A"
"49.111.218.161","16762","14.167.111.225","443","1","46","1","46","0","0","0.021489000","0.0000","N/A","N/A"
"206.71.82.85","2775","232.60.179.162","443","1","64","0","0","1","64","0.021493000","0.0000","N/A","N/A"
"131.51.31.152","1589","176.205.189.83","80","1","52","1","52","0","0","0.021505000","0.0000","N/A","N/A"
"48.203.23.106","2521","80.90.84.26","80","1","56","1","56","0","0","0.021517000","0.0000","N/A","N/A"
"188.247.137.223","22204","76.56.16.16","80","1","46","0","0","1","46","0.021517000","0.0000","N/A","N/A"
"131.19.218.14","59936","211.231.175.234","8777","9","454","9","454","0","0","0.021537000","0.0129","281179.84","N/A"
"78.225.76.228","12441","181.175.224.85","443","5","2040","0","0","5","2040","0.021542000","0.0103","N/A","1577421.23"
"138.28.247.137","17963","176.205.174.33","80","2","92","2","92","0","0","0.021547000","0.0000","81777777.78","N/A"
"12.253.66.225","39562","70.7.177.78","43","1","64","0","0","1","64","0.021549000","0.0000","N/A","N/A"
"181.175.234.67","62079","170.60.48.55","80","10","460","10","460","0","0","0.021568000","0.0018","2070906.02","N/A"
"232.60.177.187","42639","29.22.12.249","80","1","740","1","740","0","0","0.021578000","0.0000","N/A","N/A"
"131.12.105.5","52997","36.225.110.202","8080","4","184","4","184","0","0","0.021615000","0.0128","115396.68","N/A"
"180.129.149.37","46066","92.52.238.166","443","1","81","1","81","0","0","0.021620000","0.0000","N/A","N/A"
"141.70.50.106","24485","36.3.67.139","80","4","6016","0","0","4","6016","0.021638000","0.0000","N/A","1093818181.82"
"48.7.69.144","49302","92.52.238.188","80","1","81","1","81","0","0","0.021641000","0.0000","N/A","N/A"
"181.175.231.181","37662","199.174.53.50","80","2","529","2","529","0","0","0.021643000","0.0127","332835.23","N/A"
"222.7.164.111","33701","58.57.201.254","80","5","292","5","292","0","0","0.021656000","0.0001","30736842.11","N/A"
"132.42.61.86","57826","36.3.137.115","443","1","56","1","56","0","0","0.021669000","0.0000","N/A","N/A"
"43.238.49.206","51562","211.231.170.106","80","6","276","6","276","0","0","0.021684000","0.0017","1329319.69","N/A"
"132.245.227.31","4278","177.54.70.75","80","1","46","1","46","0","0","0.021685000","0.0000","N/A","N/A"
"132.42.61.87","57202","36.3.137.106","443","1","56","1","56","0","0","0.021688000","0.0000","N/A","N/A"
"74.110.251.204","36460","181.175.233.22","80","1","56","0","0","1","56","0.021707000","0.0000","N/A","N/A"
"43.43.170.218","60627","211.231.164.210","8182","1","46","1","46","0","0","0.021735000","0.0000","N/A","N/A"
"15.173.160.233","37711","75.179.114.204","80","1","56","1","56","0","0","0.021755000","0.0000","N/A","N/A"
"94.234.13.232","4421","192.174.42.144","445","1","52","1","52","0","0","0.021764000","0.0000","N/A","N/A"
"232.60.179.240","44509","58.57.201.148","80","4","224","4","224","0","0","0.021776000","0.0004","4468827.93","N/A"
"131.240.15.96","10389","36.3.67.202","443","1","326","0","0","1","326","0.021819000","0.0000","N/A","N/A"
"71.126.4.174","35961","181.175.237.236","80","1","56","0","0","1","56","0.021847000","0.0000","N/A","N/A"
"141.150.60.156","52884","232.60.179.223","443","2","2992","0","0","2","2992","0.021850000","0.0000","N/A","1994666666.67"
"142.89.99.81","14957","232.60.178.246","80","3","4332","0","0","3","4332","0.021855000","0.0000","N/A","1444000000.00"
"75.224.151.204","46051","243.98.113.149","80","3","3416","0","0","3","3416","0.021866000","0.0003","N/A","107590551.18"
"73.242.39.226","60327","135.249.214.156","7304","1","46","0","0","1","46","0.021870000","0.0000","N/A","N/A"
"81.142.103.10","54313","151.41.219.4","23348","1","46","0","0","1","46","0.021881000","0.0000","N/A","N/A"
"131.246.13.30","52875","232.60.178.102","443","2","2892","0","0","2","2892","0.021908000","0.0000","N/A","1928000000.00"
"177.96.248.165","59984","73.228.140.131","1935","7","8479","0","0","7","8479","0.021936000","0.0000","N/A","1356640000.00"
"77.140.192.9","5198","211.231.175.252","80","1","46","1","46","0","0","0.021942000","0.0000","N/A","N/A"
"196.37.228.245","4310","48.34.131.253","1002","1","46","1","46","0","0","0.021949000","0.0000","N/A","N/A"
"150.227.29.230","49583","74.116.201.73","80","2","92","2","92","0","0","0.021959000","0.0047","157635.47","N/A"
"0.140.31.106","48775","150.162.72.209","1120","1","52","0","0","1","52","0.021988000","0.0000","N/A","N/A"
"94.46.143.145","60174","211.231.175.116","80","25","1400","25","1400","0","0","0.021991000","0.0070","1599086.24","N/A"
"232.60.179.236","56242","58.57.201.151","80","2","112","2","112","0","0","0.021993000","0.0018","505643.34","N/A"
"34.251.246.114","29336","80.82.58.35","1935","6","6654","0","0","6","6654","0.022006000","0.0000","N/A","1237953488.37"
"83.31.143.255","55487","232.82.109.121","445","1","210","1","210","0","0","0.022024000","0.0000","N/A","N/A"
"181.0.181.165","47759","181.175.233.22","80","1","56","0","0","1","56","0.022025000","0.0000","N/A","N/A"
"188.245.173.253","51413","41.17.200.174","50721","1","46","0","0","1","46","0.022045000","0.0000","N/A","N/A"
"49.114.151.171","12962","58.57.200.104","443","1","56","1","56","0","0","0.022045000","0.0000","N/A","N/A"
"92.247.113.141","62666","232.60.178.232","443","1","1203","0","0","1","1203","0.022074000","0.0000","N/A","N/A"
"151.166.189.149","5144","74.116.201.200","80","2","92","2","92","0","0","0.022076000","0.0022","340898.56","N/A"
"92.249.93.66","21636","181.175.230.104","80","1","50","0","0","1","50","0.022076000","0.0000","N/A","N/A"
"159.197.138.209","49735","181.0.16.83","8081","1","480","0","0","1","480","0.022080000","0.0000","N/A","N/A"
"232.60.178.112","40996","181.0.120.85","80","4","224","4","224","0","0","0.022090000","0.0000","37333333.33","N/A"
"36.103.114.206","58056","92.52.238.180","443","1","46","1","46","0","0","0.022100000","0.0000","N/A","N/A"
"142.83.66.251","12629","232.60.178.90","80","1","56","0","0","1","56","0.022113000","0.0000","N/A","N/A"
"34.194.237.229","62615","178.15.156.122","80","2","2992","0","0","2","2992","0.022125000","0.0000","N/A","2992000000.00"
"140.196.222.141","49763","211.231.171.101","80","8","368","8","368","0","0","0.022135000","0.0149","197107.66","N/A"
"232.60.178.236","54869","58.57.201.254","80","1","796","1","796","0","0","0.022146000","0.0000","N/A","N/A"
"92.163.78.106","25565","153.239.177.199","13619","1","46","0","0","1","46","0.022146000","0.0000","N/A","N/A"
"77.197.185.4","49536","56.118.8.135","993","1","56","1","56","0","0","0.022155000","0.0000","N/A","N/A"
"43.252.10.6","59483","211.231.171.101","80","29","1972","29","1972","0","0","0.022194000","0.0146","1083070.16","N/A"
"181.0.120.82","56662","181.175.235.132","80","1","56","0","0","1","56","0.022205000","0.0000","N/A","N/A"
"58.57.201.239","50197","181.175.235.132","80","21","29334","0","0","21","29334","0.022226000","0.0002","N/A","1096598130.84"
"232.60.179.228","50962","216.19.0.247","80","1","737","1","737","0","0","0.022239000","0.0000","N/A","N/A"
"209.2.70.135","52331","81.87.82.38","80","1","416","1","416","0","0","0.022245000","0.0000","N/A","N/A"
"181.168.155.90","36118","223.146.191.80","80","1","46","0","0","1","46","0.022287000","0.0000","N/A","N/A"
"142.70.246.15","61398","232.60.179.225","443","5","7480","0","0","5","7480","0.022301000","0.0047","N/A","12721088.44"
"81.38.182.2","51339","186.237.209.220","80","1","1364","0","0","1","1364","0.022303000","0.0000","N/A","N/A"
"77.140.198.218","57391","148.168.216.74","80","3","168","3","168","0","0","0.022330000","0.0079","171035.89","N/A"
"43.30.159.228","8830","75.179.215.202","443","1","486","1","486","0","0","0.022336000","0.0000","N/A","N/A"
"142.81.181.78","56786","36.3.67.226","443","1","1496","0","0","1","1496","0.022340000","0.0000","N/A","N/A"
"49.113.101.231","50103","71.85.125.235","80","7","476","7","476","0","0","0.022343000","0.0068","563563.71","N/A"
"150.66.224.182","49806","73.78.58.51","443","1","46","1","46","0","0","0.022350000","0.0000","N/A","N/A"
"151.232.145.209","63828","181.168.161.170","80","2","112","2","112","0","0","0.022358000","0.0101","88827.20","N/A"
"138.28.196.135","21745","58.57.200.97","443","1","46","1","46","0","0","0.022364000","0.0000","N/A","N/A"
"53.98.31.189","31194","215.121.159.82","80","1","56","0","0","1","56","0.022389000","0.0000","N/A","N/A"
"232.31.17.186","35968","71.126.28.245","80","5","280","5","280","0","0","0.022397000","0.0032","689442.91","N/A"
"138.82.148.123","45105","73.151.139.236","80","2","112","2","112","0","0","0.022410000","0.0000","20363636.36","N/A"
"131.245.225.76","56192","232.60.177.211","443","1","56","0","0","1","56","0.022441000","0.0000","N/A","N/A"
"40.171.25.186","60596","179.148.164.148","80","2","112","2","112","0","0","0.022452000","0.0019","481461.58","N/A"
"90.35.73.62","49515","81.87.82.39","80","1","56","1","56","0","0","0.022452000","0.0000","N/A","N/A"
"36.225.197.138","8080","91.36.58.202","1433","1","46","0","0","1","46","0.022509000","0.0000","N/A","N/A"
"90.49.130.173","54614","211.231.164.53","80","7","342","7","342","0","0","0.022561000","0.0124","221323.41","N/A"
"204.78.119.36","10056","75.179.215.213","443","1","46","1","46","0","0","0.022564000","0.0000","N/A","N/A"
"43.237.126.55","61665","211.231.161.79","8081","1","46","1","46","0","0","0.022569000","0.0000","N/A","N/A"
"75.224.151.124","46155","73.168.180.142","80","1","50","0","0","1","50","0.022599000","0.0000","N/A","N/A"
"142.70.72.230","26579","232.60.179.225","80","2","2888","0","0","2","2888","0.022614000","0.0000","N/A","1650285714.29"
"232.60.178.249","58532","216.19.1.138","80","3","168","3","168","0","0","0.022615000","0.0001","10500000.00","N/A"
"179.202.151.255","1176","73.177.104.42","80","1","46","1","46","0","0","0.022652000","0.0000","N/A","N/A"
"132.44.62.145","48710","92.238.90.231","80","1","68","1","68","0","0","0.022655000","0.0000","N/A","N/A"
"39.44.237.112","24754","215.75.86.168","443","1","50","0","0","1","50","0.022678000","0.0000","N/A","N/A"
"131.244.143.85","28036","232.60.178.72","80","1","50","0","0","1","50","0.022685000","0.0000","N/A","N/A"
"0.217.13.122","57042","49.115.40.247","28147","1","46","0","0","1","46","0.022694000","0.0000","N/A","N/A"
"215.74.154.217","48719","92.238.90.83","3905","1","64","1","64","0","0","0.022700000","0.0000","N/A","N/A"
"43.30.144.51","27060","58.57.200.97","443","1","64","1","64","0","0","0.022710000","0.0000","N/A","N/A"
"36.217.235.169","55184","211.248.115.147","80","1","50","1","50","0","0","0.022715000","0.0000","N/A","N/A"
"77.145.143.76","2182","181.30.32.90","445","1","52","1","52","0","0","0.022727000","0.0000","N/A","N/A"
"36.3.67.210","42769","58.57.201.254","80","2","112","2","112","0","0","0.022765000","0.0001","6787878.79","N/A"
"142.91.221.109","27769","232.60.177.182","443","1","1393","0","0","1","1393","0.022767000","0.0000","N/A","N/A"
"71.126.3.204","57668","64.125.233.139","443","15","22560","0","0","15","22560","0.022781000","0.0003","N/A","591737704.92"
"181.97.4.109","33714","80.75.112.248","80","1","68","0","0","1","68","0.022789000","0.0000","N/A","N/A"
"219.126.173.159","36259","181.9.99.102","80","1","1061","1","1061","0","0","0.022791000","0.0000","N/A","N/A"
"43.30.193.244","35819","75.179.215.202","443","1","68","1","68","0","0","0.022801000","0.0000","N/A","N/A"
"130.17.10.63","52350","211.231.175.47","80","14","952","14","952","0","0","0.022808000","0.0134","569548.31","N/A"
"88.193.90.95","52390","232.60.179.154","443","1","56","0","0","1","56","0.022819000","0.0000","N/A","N/A"
"43.253.42.46","50783","75.179.10.106","443","1","56","1","56","0","0","0.022823000","0.0000","N/A","N/A"
"36.63.135.136","61566","232.27.0.191","443","2","112","2","112","0","0","0.022847000","0.0000","74666666.67","N/A"
"36.3.67.149","35410","74.110.251.26","80","1","1063","1","1063","0","0","0.022876000","0.0000","N/A","N/A"
"219.126.173.132","56414","181.9.99.89","80","1","56","1","56","0","0","0.022887000","0.0000","N/A","N/A"
"71.248.19.88","55145","73.168.177.160","80","1","1133","0","0","1","1133","0.022956000","0.0000","N/A","N/A"
"71.215.84.94","54395","181.175.235.118","80","1","56","0","0","1","56","0.023054000","0.0000","N/A","N/A"
"180.135.193.118","2054","92.52.238.166","443","1","81","1","81","0","0","0.023066000","0.0000","N/A","N/A"
"48.6.81.67","60884","149.184.94.93","1935","1","46","1","46","0","0","0.023077000","0.0000","N/A","N/A"
"135.244.220.52","53592","211.231.164.53","80","6","276","6","276","0","0","0.023109000","0.0137","161604.33","N/A"
"88.151.168.10","53308","73.228.140.95","1935","6","5869","0","0","6","5869","0.023131000","0.0001","N/A","643178082.19"
"131.240.238.120","13849","36.3.67.167","443","9","12996","0","0","9","12996","0.023133000","0.0135","N/A","7696202.53"
"150.2.190.18","13211","148.60.7.157","80","3","1886","3","1886","0","0","0.023147000","0.0011","13617328.52","N/A"
"73.38.228.110","51880","77.73.50.42","80","1","50","0","0","1","50","0.023149000","0.0000","N/A","N/A"
"176.217.34.100","32855","74.116.201.111","443","2","112","2","112","0","0","0.023164000","0.0009","1027522.94","N/A"
"131.240.255.134","50377","232.60.178.91","80","1","50","0","0","1","50","0.023175000","0.0000","N/A","N/A"
"148.190.2.109","8080","94.180.71.126","2675","4","184","0","0","4","184","0.023182000","0.0099","N/A","148566.81"
"141.148.225.254","23557","36.3.67.171","443","2","2888","0","0","2","2888","0.023190000","0.0000","N/A","2567111111.11"
"131.245.125.207","52083","232.60.179.144","443","3","4488","0","0","3","4488","0.023215000","0.0000","N/A","1709714285.71"
"49.75.75.184","51252","181.168.250.10","80","1","56","1","56","0","0","0.023249000","0.0000","N/A","N/A"
"133.203.23.222","46639","71.85.125.138","80","1","994","1","994","0","0","0.023253000","0.0000","N/A","N/A"
"43.236.54.157","59435","211.231.170.69","80","9","414","9","414","0","0","0.023255000","0.0011","2887532.69","N/A"
"148.162.201.37","52812","211.231.161.79","8880","1","56","1","56","0","0","0.023256000","0.0000","N/A","N/A"
"73.38.228.110","51873","77.73.50.42","80","1","50","0","0","1","50","0.023269000","0.0000","N/A","N/A"
"70.135.1.90","52213","181.175.235.102","443","1","257","0","0","1","257","0.023270000","0.0000","N/A","N/A"
"141.150.61.20","17476","36.3.67.136","443","2","2968","0","0","2","2968","0.023291000","0.0077","N/A","3081635.30"
"129.112.163.222","51056","176.205.189.89","80","1","46","1","46","0","0","0.023330000","0.0000","N/A","N/A"
"229.226.97.210","49832","71.85.124.252","1935","1","78","1","78","0","0","0.023345000","0.0000","N/A","N/A"
"232.23.227.25","38841","133.203.23.169","9050","1","100","0","0","1","100","0.023349000","0.0000","N/A","N/A"
"142.81.106.177","3329","36.3.67.166","443","1","56","0","0","1","56","0.023408000","0.0000","N/A","N/A"
"232.60.179.188","42015","58.57.100.241","80","1","56","1","56","0","0","0.023417000","0.0000","N/A","N/A"
"61.55.29.154","57592","137.135.142.26","24602","1","64","0","0","1","64","0.023447000","0.0000","N/A","N/A"
"82.147.246.228","64248","177.207.5.165","3389","2","764","2","764","0","0","0.023461000","0.0001","80421052.63","N/A"
"191.121.3.5","64156","36.62.7.229","9050","1","826","0","0","1","826","0.023465000","0.0000","N/A","N/A"
"50.19.161.245","8080","131.169.72.136","3167","3","138","0","0","3","138","0.023468000","0.0081","N/A","136735.20"
"232.60.179.179","47110","181.0.120.84","80","2","112","2","112","0","0","0.023496000","0.0001","17568627.45","N/A"
"49.142.112.238","51190","73.168.182.201","80","11","16544","0","0","11","16544","0.023513000","0.0018","N/A","73651641.62"
"232.60.178.236","44305","71.215.84.102","80","3","168","3","168","0","0","0.023528000","0.0000","35368421.05","N/A"
"131.245.54.74","13620","36.3.67.168","80","2","2888","0","0","2","2888","0.023533000","0.0000","N/A","1777230769.23"
"140.242.76.231","29239","92.167.107.219","14600","1","56","1","56","0","0","0.023548000","0.0000","N/A","N/A"
"95.64.2.175","59773","211.231.161.79","8081","1","46","1","46","0","0","0.023565000","0.0000","N/A","N/A"
"150.2.190.18","12939","148.60.7.157","80","1","46","1","46","0","0","0.023582000","0.0000","N/A","N/A"
"148.190.1.90","41094","10.205.228.244","7000","1","46","0","0","1","46","0.023589000","0.0000","N/A","N/A"
"198.244.194.62","55654","75.179.10.103","443","2","139","2","139","0","0","0.023617000","0.0001","22240000.00","N/A"
"71.85.125.250","50734","181.175.224.85","443","3","3342","0","0","3","3342","0.023647000","0.0001","N/A","219147540.98"
"243.123.248.53","65388","92.61.251.62","25","1","1424","1","1424","0","0","0.023657000","0.0000","N/A","N/A"
"36.3.67.174","56513","58.57.201.148","80","3","168","3","168","0","0","0.023670000","0.0001","16000000.00","N/A"
"179.158.147.118","50449","179.231.228.109","5647","1","46","1","46","0","0","0.023687000","0.0000","N/A","N/A"
"92.23.63.165","38491","36.3.67.138","80","2","3008","0","0","2","3008","0.023691000","0.0000","N/A","1851076923.08"
"131.245.97.108","15555","36.3.67.195","443","1","50","0","0","1","50","0.023697000","0.0000","N/A","N/A"
"198.244.194.62","40471","75.179.10.103","443","2","139","2","139","0","0","0.023720000","0.0005","2311850.31","N/A"
"82.146.81.115","30741","80.74.173.71","80","1","56","1","56","0","0","0.023734000","0.0000","N/A","N/A"
"216.42.62.79","51912","29.22.12.181","80","1","56","1","56","0","0","0.023813000","0.0000","N/A","N/A"
"71.126.3.204","39494","181.175.235.117","80","2","2377","0","0","2","2377","0.023822000","0.0000","N/A","19015999999.98"
"219.126.173.133","46560","58.57.201.215","80","1","56","1","56","0","0","0.023824000","0.0000","N/A","N/A"
"211.188.128.236","46544","75.179.10.117","80","2","540","2","540","0","0","0.023834000","0.0000","720000000.00","N/A"
"141.145.37.14","56732","36.3.67.226","80","1","1484","0","0","1","1484","0.023836000","0.0000","N/A","N/A"
"91.96.53.86","49455","178.61.254.98","9510","1","46","1","46","0","0","0.023838000","0.0000","N/A","N/A"
"131.253.141.132","16221","232.60.179.155","80","1","1444","0","0","1","1444","0.023863000","0.0000","N/A","N/A"
"133.203.23.205","36510","74.110.251.245","80","2","112","2","112","0","0","0.023864000","0.0000","49777777.78","N/A"
"131.246.50.21","26745","232.60.178.255","443","1","1444","0","0","1","1444","0.023867000","0.0000","N/A","N/A"
"133.203.13.145","61333","36.123.19.250","80","1","56","1","56","0","0","0.023875000","0.0000","N/A","N/A"
"142.89.42.189","62324","232.60.178.255","80","2","2805","0","0","2","2805","0.023879000","0.0000","N/A","1726153846.15"
"142.84.251.161","27567","232.60.179.186","443","1","1444","0","0","1","1444","0.023885000","0.0000","N/A","N/A"
"141.35.144.194","15553","81.87.82.39","80","1","56","1","56","0","0","0.023892000","0.0000","N/A","N/A"
"142.85.31.156","50132","232.60.177.233","80","1","56","0","0","1","56","0.024002000","0.0000","N/A","N/A"
"182.184.248.112","10808","179.22.29.160","6140","2","112","2","112","0","0","0.024007000","0.0084","106565.18","N/A"
"138.25.186.228","2676","36.3.67.152","443","1","56","0","0","1","56","0.024034000","0.0000","N/A","N/A"
"189.143.226.93","34104","215.121.226.2","80","1","64","0","0","1","64","0.024039000","0.0000","N/A","N/A"
"232.23.227.20","35936","138.82.149.199","9050","1","372","0","0","1","372","0.024040000","0.0000","N/A","N/A"
"74.110.251.19","34480","181.175.235.132","80","56","78656","0","0","56","78656","0.024060000","0.0004","N/A","1772529577.46"
"131.17.90.139","3887","211.231.164.53","80","2","92","2","92","0","0","0.024106000","0.0000","N/A","N/A"
"177.73.73.128","10719","154.111.12.56","80","2","2848","0","0","2","2848","0.024141000","0.0002","N/A","143295597.48"
"219.23.236.59","49559","81.87.82.39","80","1","68","1","68","0","0","0.024150000","0.0000","N/A","N/A"
"179.180.129.137","59253","218.200.20.179","44173","1","124","0","0","1","124","0.024160000","0.0000","N/A","N/A"
"82.147.246.228","64277","177.207.7.84","3389","1","56","1","56","0","0","0.024176000","0.0000","N/A","N/A"
"181.175.233.7","55350","73.177.30.228","80","10","560","10","560","0","0","0.024185000","0.0014","3141654.98","N/A"
"181.103.188.164","2213","58.57.248.105","80","1","254","1","254","0","0","0.024189000","0.0000","N/A","N/A"
"58.57.201.248","51282","181.175.235.118","80","1","56","0","0","1","56","0.024208000","0.0000","N/A","N/A"
"43.30.144.51","27063","58.57.200.97","443","1","64","1","64","0","0","0.024209000","0.0000","N/A","N/A"
"148.161.202.24","53049","191.235.251.221","1935","1","46","1","46","0","0","0.024215000","0.0000","N/A","N/A"
"181.9.99.97","64536","181.175.235.132","80","1","56","0","0","1","56","0.024216000","0.0000","N/A","N/A"
"132.42.56.97","38320","92.47.210.210","80","2","112","2","112","0","0","0.024221000","0.0003","2890322.58","N/A"
"50.46.59.234","63399","232.60.176.62","80","2","3008","0","0","2","3008","0.024232000","0.0000","N/A","2673777777.78"
"132.42.61.85","36723","232.17.5.89","443","1","317","1","317","0","0","0.024250000","0.0000","N/A","N/A"
"229.140.111.43","11058","74.116.201.200","80","1","46","1","46","0","0","0.024255000","0.0000","N/A","N/A"
"74.110.251.205","56332","181.175.233.22","80","1","56","0","0","1","56","0.024307000","0.0000","N/A","N/A"
"140.245.81.7","16964","81.107.111.254","8080","1","46","1","46","0","0","0.024320000","0.0000","N/A","N/A"
"72.157.218.243","49910","211.188.19.162","443","1","1421","0","0","1","1421","0.024326000","0.0000","N/A","N/A"
"150.2.190.18","12752","148.60.7.157","80","1","46","1","46","0","0","0.024329000","0.0000","N/A","N/A"
"71.215.84.82","46745","181.175.235.116","80","11","15524","0","0","11","15524","0.024341000","0.0001","N/A","1009691056.91"
"222.6.126.81","35251","29.22.12.247","80","1","56","1","56","0","0","0.024359000","0.0000","N/A","N/A"
"141.145.35.178","2429","73.151.139.186","80","1","46","1","46","0","0","0.024365000","0.0000","N/A","N/A"
"129.121.2.85","1611","211.231.171.101","80","2","92","2","92","0","0","0.024366000","0.0000","20444444.44","N/A"
"232.60.179.89","48918","71.199.4.41","80","15","840","15","840","0","0","0.024370000","0.0124","540888.60","N/A"
"142.91.151.51","5064","232.60.177.225","80","1","1331","0","0","1","1331","0.024390000","0.0000","N/A","N/A"
"58.57.201.108","34164","181.175.233.22","80","7","9165","0","0","7","9165","0.024471000","0.0001","N/A","1242711864.41"
"177.96.248.86","57399","129.131.122.4","22231","1","74","0","0","1","74","0.024476000","0.0000","N/A","N/A"
"180.169.148.174","1619","72.64.127.6","443","1","46","0","0","1","46","0.024482000","0.0000","N/A","N/A"
"151.188.38.140","12672","74.116.201.38","80","1","46","1","46","0","0","0.024493000","0.0000","N/A","N/A"
"232.60.179.157","63792","71.215.84.24","80","1","56","1","56","0","0","0.024531000","0.0000","N/A","N/A"
"232.60.179.176","63270","216.19.0.253","80","1","56","1","56","0","0","0.024554000","0.0000","N/A","N/A"
"137.88.247.89","1164","148.163.42.170","80","1","46","1","46","0","0","0.024570000","0.0000","N/A","N/A"
"70.135.1.96","39738","181.175.224.85","443","2","159","0","0","2","159","0.024595000","0.0009","N/A","1350318.47"
"176.214.158.7","36035","215.75.86.124","80","2","459","0","0","2","459","0.024604000","0.0055","N/A","668608.89"
"196.37.208.37","7967","211.231.175.53","182","1","64","1","64","0","0","0.024604000","0.0000","N/A","N/A"
"232.60.179.236","63856","181.0.183.95","80","2","112","2","112","0","0","0.024611000","0.0000","40727272.73","N/A"
"232.35.1.226","62040","73.151.139.131","80","18","1008","18","1008","0","0","0.024624000","0.0104","773822.09","N/A"
"154.95.19.14","22098","36.3.67.202","443","5","6193","0","0","5","6193","0.024631000","0.0000","N/A","1208390243.90"
"88.195.216.20","51909","36.3.67.144","443","5","5713","0","0","5","5713","0.024632000","0.0002","N/A","185788617.89"
"141.151.239.231","60479","36.3.67.193","443","2","2992","0","0","2","2992","0.024636000","0.0000","N/A","1139809523.81"
"181.131.87.10","13652","80.92.11.123","993","1","569","0","0","1","569","0.024637000","0.0000","N/A","N/A"
"91.146.81.72","5587","159.241.157.167","80","1","56","1","56","0","0","0.024661000","0.0000","N/A","N/A"
"232.60.179.149","44661","58.57.201.150","80","2","112","2","112","0","0","0.024663000","0.0000","32000000.00","N/A"
"150.2.190.18","13221","148.60.7.157","80","1","46","1","46","0","0","0.024689000","0.0000","N/A","N/A"
"148.166.16.214","57102","153.231.132.235","25","1","68","0","0","1","68","0.024690000","0.0000","N/A","N/A"
"138.179.188.45","7605","232.60.178.252","443","1","310","0","0","1","310","0.024729000","0.0000","N/A","N/A"
"43.30.154.68","62895","75.179.215.202","443","1","525","1","525","0","0","0.024757000","0.0000","N/A","N/A"
"71.85.125.49","57972","222.7.140.70","80","1","64","0","0","1","64","0.024766000","0.0000","N/A","N/A"
"191.121.72.147","53885","58.57.201.88","80","4","224","4","224","0","0","0.024780000","0.0009","2093457.94","N/A"
"89.5.207.216","54929","211.231.161.42","80","1","56","1","56","0","0","0.024813000","0.0000","N/A","N/A"
"28.34.220.120","36908","73.168.180.141","80","1","56","0","0","1","56","0.024823000","0.0000","N/A","N/A"
"142.81.87.138","25193","232.60.178.213","443","1","1444","0","0","1","1444","0.024836000","0.0000","N/A","N/A"
"70.135.1.23","56656","215.121.226.2","80","1","56","0","0","1","56","0.024858000","0.0000","N/A","N/A"
"232.31.17.114","39191","75.226.168.53","80","1","56","1","56","0","0","0.024879000","0.0000","N/A","N/A"
"43.30.160.114","31787","75.179.215.213","443","1","529","1","529","0","0","0.024893000","0.0000","N/A","N/A"
"241.255.116.124","9542","189.129.142.27","80","9","504","9","504","0","0","0.024911000","0.0029","1396121.88","N/A"
"58.57.201.79","59373","181.175.235.116","80","5","7373","0","0","5","7373","0.024922000","0.0000","N/A","2681090909.09"
"58.119.153.253","33322","216.115.86.54","80","1","56","0","0","1","56","0.024924000","0.0000","N/A","N/A"
"141.209.243.173","54422","71.85.125.218","80","1","68","1","68","0","0","0.024946000","0.0000","N/A","N/A"
"25.77.183.9","56692","36.86.135.153","80","1","56","1","56","0","0","0.024951000","0.0000","N/A","N/A"
"191.121.75.147","36912","29.22.12.167","80","1","956","1","956","0","0","0.024953000","0.0000","N/A","N/A"
"232.31.17.176","62460","36.120.84.173","80","1","56","1","56","0","0","0.024972000","0.0000","N/A","N/A"
"232.31.17.120","45984","75.224.151.172","80","1","1153","1","1153","0","0","0.024980000","0.0000","N/A","N/A"
"181.0.181.160","61450","181.175.235.133","80","1","56","0","0","1","56","0.024983000","0.0000","N/A","N/A"
"181.9.99.143","64271","191.121.72.230","80","3","3352","0","0","3","3352","0.025015000","0.0000","N/A","2234666666.67"
"83.116.92.70","54667","211.231.170.42","80","2","92","2","92","0","0","0.025027000","0.0001","13142857.14","N/A"
"55.156.3.45","27129","73.151.139.181","443","3","647","3","647","0","0","0.025038000","0.0110","471789.26","N/A"
"142.85.86.171","12643","36.3.67.218","443","2","239","0","0","2","239","0.025052000","0.0020","N/A","933593.75"
"36.225.47.154","8080","253.176.143.220","3284","2","102","0","0","2","102","0.025053000","0.0000","N/A","N/A"
"216.22.2.90","57397","73.168.180.142","80","3","4512","0","0","3","4512","0.025061000","0.0000","N/A","6016000000.00"
"216.42.62.14","34556","29.22.12.229","80","1","1121","1","1121","0","0","0.025066000","0.0000","N/A","N/A"
"130.208.252.117","59620","81.230.167.231","19385","1","50","1","50","0","0","0.025083000","0.0000","N/A","N/A"
"211.188.105.176","59268","224.243.33.19","443","1","572","1","572","0","0","0.025087000","0.0000","N/A","N/A"
"58.57.201.231","37665","181.175.235.116","80","6","7779","0","0","6","7779","0.025107000","0.0000","N/A","1296500000.00"
"90.31.87.140","50037","177.54.88.192","80","1","46","1","46","0","0","0.025108000","0.0000","N/A","N/A"
"223.171.177.37","50286","232.60.178.244","443","1","1496","0","0","1","1496","0.025124000","0.0000","N/A","N/A"
"72.157.218.242","59607","211.188.19.162","443","1","64","0","0","1","64","0.025128000","0.0000","N/A","N/A"
"133.203.22.1","35825","71.126.3.235","80","3","168","3","168","0","0","0.025137000","0.0003","5071698.11","N/A"
"131.253.81.25","1227","232.60.178.73","80","2","2992","0","0","2","2992","0.025166000","0.0000","N/A","1709714285.71"
"132.176.54.117","49595","211.231.171.101","80","1","50","1","50","0","0","0.025169000","0.0000","N/A","N/A"
"232.23.227.21","56602","191.121.72.243","9050","1","100","0","0","1","100","0.025169000","0.0000","N/A","N/A"
"219.222.118.198","4395","211.231.170.42","80","2","92","2","92","0","0","0.025173000","0.0016","447961.05","N/A"
"211.250.164.207","4907","222.111.81.222","445","1","46","0","0","1","46","0.025224000","0.0000","N/A","N/A"
"71.248.19.123","49830","73.168.177.160","80","2","3008","0","0","2","3008","0.025242000","0.0004","N/A","63830238.73"
"77.204.143.71","33767","81.134.50.197","25","1","56","1","56","0","0","0.025269000","0.0000","N/A","N/A"
"58.57.179.178","47539","181.175.240.12","80","2","112","2","112","0","0","0.025309000","0.0001","17568627.45","N/A"
"133.203.23.208","61245","29.22.12.201","80","1","733","1","733","0","0","0.025348000","0.0000","N/A","N/A"
"43.30.193.244","35821","75.179.215.202","443","1","68","1","68","0","0","0.025350000","0.0000","N/A","N/A"
"95.164.166.142","40721","58.57.201.121","80","3","168","3","168","0","0","0.025350000","0.0001","9669064.75","N/A"
"77.204.143.71","33766","81.134.50.197","25","1","56","1","56","0","0","0.025378000","0.0000","N/A","N/A"
"229.173.107.238","5700","74.116.201.198","80","1","46","1","46","0","0","0.025383000","0.0000","N/A","N/A"
"40.213.150.48","5971","232.60.178.230","443","1","50","0","0","1","50","0.025423000","0.0000","N/A","N/A"
"36.63.135.132","62073","36.120.240.138","80","1","56","1","56","0","0","0.025443000","0.0000","N/A","N/A"
"43.30.166.40","24049","75.179.215.229","443","1","56","1","56","0","0","0.025462000","0.0000","N/A","N/A"
"28.34.188.122","55218","49.116.4.21","24601","1","46","0","0","1","46","0.025508000","0.0000","N/A","N/A"
"36.102.115.213","20725","92.52.238.147","443","1","173","1","173","0","0","0.025509000","0.0000","N/A","N/A"
"133.42.205.9","34074","211.231.164.53","80","1","56","1","56","0","0","0.025516000","0.0000","N/A","N/A"
"71.199.4.205","46947","181.255.19.254","443","1","56","0","0","1","56","0.025517000","0.0000","N/A","N/A"
"232.56.226.16","59751","58.57.179.245","80","1","1417","0","0","1","1417","0.025533000","0.0000","N/A","N/A"
"183.15.132.36","8080","92.186.82.213","4023","1","336","0","0","1","336","0.025534000","0.0000","N/A","N/A"
"232.60.179.129","52077","181.0.120.8","80","1","808","1","808","0","0","0.025535000","0.0000","N/A","N/A"
"43.234.58.107","62561","81.87.82.39","80","1","56","1","56","0","0","0.025536000","0.0000","N/A","N/A"
"91.148.86.34","40996","211.231.171.101","80","1","56","1","56","0","0","0.025543000","0.0000","N/A","N/A"
"211.144.77.143","49272","12.254.8.66","29200","1","46","1","46","0","0","0.025551000","0.0000","N/A","N/A"
"138.24.131.199","53451","232.60.179.169","443","1","56","0","0","1","56","0.025551000","0.0000","N/A","N/A"
"232.31.17.239","42318","181.0.143.56","25","9","13536","9","13536","0","0","0.025559000","0.0001","1082880000.00","N/A"
"77.89.248.21","49973","36.225.6.189","8080","1","46","1","46","0","0","0.025560000","0.0000","N/A","N/A"
"83.76.193.11","3296","73.151.139.149","443","2","639","2","639","0","0","0.025576000","0.0000","511200000.00","N/A"
"141.26.200.203","52168","29.22.12.247","443","2","92","2","92","0","0","0.025589000","0.0077","95895.77","N/A"
"178.73.216.214","54257","211.188.124.56","80","44","66176","0","0","44","66176","0.025595000","0.0039","N/A","137223431.83"
"215.74.54.235","56075","156.76.139.174","80","1","56","1","56","0","0","0.025631000","0.0000","N/A","N/A"
"131.107.236.39","26326","75.179.10.109","443","1","56","1","56","0","0","0.025645000","0.0000","N/A","N/A"
"58.57.101.236","47515","181.175.235.133","80","7","9989","0","0","7","9989","0.025649000","0.0000","N/A","4439555555.56"
"229.185.33.123","49905","211.231.169.234","80","1","56","1","56","0","0","0.025656000","0.0000","N/A","N/A"
"231.13.242.70","63058","153.56.133.113","44812","1","64","0","0","1","64","0.025671000","0.0000","N/A","N/A"
"215.74.154.217","55317","92.238.90.97","9595","1","64","1","64","0","0","0.025678000","0.0000","N/A","N/A"
"140.200.36.204","51974","211.231.171.101","80","3","138","3","138","0","0","0.025693000","0.0070","158166.19","N/A"
"36.102.242.133","23758","189.119.43.6","443","1","46","1","46","0","0","0.025699000","0.0000","N/A","N/A"
"92.127.196.158","59710","211.231.175.252","80","4","184","4","184","0","0","0.025702000","0.0080","185157.23","N/A"
"39.109.242.99","52537","181.175.235.7","5228","1","56","0","0","1","56","0.025718000","0.0000","N/A","N/A"
"131.249.192.24","49379","232.60.178.102","443","1","56","0","0","1","56","0.025764000","0.0000","N/A","N/A"
"150.2.190.18","13317","148.60.7.157","80","1","46","1","46","0","0","0.025772000","0.0000","N/A","N/A"
"138.2.217.211","2323","58.57.200.104","443","1","46","1","46","0","0","0.025800000","0.0000","N/A","N/A"
"223.144.244.70","49937","36.225.122.26","8080","4","184","4","184","0","0","0.025821000","0.0104","141171.96","N/A"
"0.216.154.43","52757","80.82.56.31","1935","6","6900","0","0","6","6900","0.025826000","0.0000","N/A","1314285714.29"
"50.3.165.197","32967","71.244.116.89","80","1","46","0","0","1","46","0.025851000","0.0000","N/A","N/A"
"133.203.23.249","61920","74.110.251.213","80","1","56","1","56","0","0","0.025865000","0.0000","N/A","N/A"
"191.121.72.66","43395","71.85.125.164","80","4","224","4","224","0","0","0.025896000","0.0001","12800000.00","N/A"
"43.30.155.244","24562","58.57.200.97","443","1","46","1","46","0","0","0.025913000","0.0000","N/A","N/A"
"137.241.171.20","53195","211.231.164.53","80","2","112","2","112","0","0","0.025921000","0.0000","81454545.45","N/A"
"177.96.248.165","62781","73.228.140.203","1935","8","9530","0","0","8","9530","0.025933000","0.0001","N/A","1155151515.15"
"25.66.225.60","55100","211.200.169.110","80","1","56","1","56","0","0","0.025947000","0.0000","N/A","N/A"
"142.89.74.52","15600","232.60.179.137","443","2","2888","0","0","2","2888","0.025948000","0.0000","N/A","1650285714.29"
"75.20.209.181","27962","232.60.178.75","443","15","19762","0","0","15","19762","0.025984000","0.0005","N/A","349769911.50"
"49.119.174.221","1256","73.151.139.181","443","2","92","2","92","0","0","0.025986000","0.0000","736000000.00","N/A"
"138.25.133.129","26370","71.85.125.229","80","2","478","2","478","0","0","0.025999000","0.0007","5370786.52","N/A"
"132.93.28.101","43063","75.179.18.192","80","1","56","1","56","0","0","0.026010000","0.0000","N/A","N/A"
"71.199.4.206","44701","243.98.126.188","443","1","1342","0","0","1","1342","0.026012000","0.0000","N/A","N/A"
"181.168.161.170","8080","218.207.207.167","4582","2","92","0","0","2","92","0.026020000","0.0101","N/A","72533.75"
"182.215.44.219","49828","80.82.58.20","1935","9","11239","0","0","9","11239","0.026030000","0.0001","N/A","1248777777.78"
"142.212.63.21","60729","211.231.171.101","80","1","46","1","46","0","0","0.026054000","0.0000","N/A","N/A"
"90.199.89.216","55301","211.231.164.165","8182","10","460","10","460","0","0","0.026078000","0.0053","693946.82","N/A"
"71.126.4.210","44062","181.175.237.236","80","1","56","0","0","1","56","0.026107000","0.0000","N/A","N/A"
"94.236.40.140","1760","80.74.173.71","80","1","56","1","56","0","0","0.026116000","0.0000","N/A","N/A"
"76.133.212.192","46092","181.168.161.11","80","1","738","1","738","0","0","0.026132000","0.0000","N/A","N/A"
"71.126.3.195","39763","181.175.235.133","80","12","16972","0","0","12","16972","0.026144000","0.0001","N/A","998352941.18"
"71.126.28.89","62516","181.175.235.133","80","6","8517","0","0","6","8517","0.026147000","0.0000","N/A","2523555555.56"
"219.217.187.96","63593","188.240.166.19","6421","1","56","1","56","0","0","0.026148000","0.0000","N/A","N/A"
"232.60.179.130","52216","58.57.101.219","80","1","1039","1","1039","0","0","0.026173000","0.0000","N/A","N/A"
"181.162.193.250","51294","179.22.29.187","8290","1","56","1","56","0","0","0.026174000","0.0000","N/A","N/A"
"179.180.193.5","51168","219.221.154.184","6699","1","940","0","0","1","940","0.026203000","0.0000","N/A","N/A"
"43.235.1.249","49443","211.231.170.26","80","3","138","3","138","0","0","0.026213000","0.0007","1645305.51","N/A"
"70.135.1.91","50103","181.175.231.233","443","4","5452","0","0","4","5452","0.026221000","0.0000","N/A","1246171428.57"
"142.213.81.96","2014","192.158.176.112","445","1","68","1","68","0","0","0.026233000","0.0000","N/A","N/A"
"223.30.255.245","59135","92.219.244.41","51413","2","100","2","100","0","0","0.026253000","0.0097","82397.78","N/A"
"135.116.131.133","56169","178.61.220.61","8006","1","56","1","56","0","0","0.026257000","0.0000","N/A","N/A"
"142.91.188.57","1379","232.60.179.226","80","2","2992","0","0","2","2992","0.026308000","0.0000","N/A","2992000000.00"
"92.163.79.53","34426","211.163.30.161","6667","3","228","0","0","3","228","0.026317000","0.0002","N/A","7663865.55"
"70.135.1.96","53395","181.175.237.236","443","2","777","0","0","2","777","0.026345000","0.0001","N/A","88800000.00"
"142.89.78.33","52108","232.60.178.89","80","1","56","0","0","1","56","0.026352000","0.0000","N/A","N/A"
"131.243.166.56","10352","232.60.178.117","443","1","50","0","0","1","50","0.026353000","0.0000","N/A","N/A"
"50.19.250.170","8080","229.195.130.205","2924","2","92","0","0","2","92","0.026357000","0.0000","N/A","368000000.00"
"229.181.206.180","51692","232.60.177.168","80","1","1275","0","0","1","1275","0.026394000","0.0000","N/A","N/A"
"216.19.0.157","43639","181.175.233.23","80","1","56","0","0","1","56","0.026402000","0.0000","N/A","N/A"
"43.225.254.187","63586","211.231.161.207","182","4","224","4","224","0","0","0.026416000","0.0028","634336.28","N/A"
"179.180.80.70","50479","154.86.154.104","80","3","4512","0","0","3","4512","0.026419000","0.0000","N/A","880390243.90"
"140.208.202.219","53743","81.87.82.38","80","2","527","2","527","0","0","0.026421000","0.0100","422191.07","N/A"
"211.188.98.176","51263","75.179.10.112","80","1","64","1","64","0","0","0.026442000","0.0000","N/A","N/A"
"92.163.79.53","34427","211.163.30.161","6667","3","228","0","0","3","228","0.026450000","0.0007","N/A","2522821.58"
"14.167.120.71","44924","159.252.165.146","1935","2","648","0","0","2","648","0.026478000","0.0003","N/A","18000000.00"
"229.170.122.13","64515","232.60.177.200","443","1","56","0","0","1","56","0.026480000","0.0000","N/A","N/A"
"135.198.83.54","56363","211.231.175.234","8777","5","240","5","240","0","0","0.026507000","0.0000","73846153.85","N/A"
"232.60.179.158","62317","181.0.142.73","80","3","168","3","168","0","0","0.026509000","0.0001","10666666.67","N/A"
"95.230.8.14","1315","211.231.161.42","80","1","46","1","46","0","0","0.026532000","0.0000","N/A","N/A"
"71.85.125.141","52591","181.175.237.236","443","1","56","0","0","1","56","0.026543000","0.0000","N/A","N/A"
"232.31.17.253","57141","71.126.3.244","80","4","224","4","224","0","0","0.026569000","0.0001","28444444.44","N/A"
"129.83.209.61","53907","211.231.175.58","80","5","230","5","230","0","0","0.026578000","0.0100","183797.82","N/A"
"71.126.3.121","58071","181.175.233.23","80","1","56","0","0","1","56","0.026602000","0.0000","N/A","N/A"
"131.246.143.14","19952","232.60.178.103","443","7","8937","0","0","7","8937","0.026623000","0.0001","N/A","851142857.14"
"90.187.132.204","12371","5.49.50.217","4411","4","6016","4","6016","0","0","0.026627000","0.0035","13723410.32","N/A"
"77.109.36.90","50624","148.168.216.90","80","2","112","2","112","0","0","0.026653000","0.0025","359406.34","N/A"
"131.32.155.187","50331","211.231.161.79","8081","3","138","3","138","0","0","0.026684000","0.0036","302880.66","N/A"
"0.222.41.61","51356","83.0.7.163","26085","2","120","0","0","2","120","0.026730000","0.0037","N/A","260092.12"
"43.30.159.55","27630","75.179.215.229","443","5","333","5","333","0","0","0.026740000","0.0103","257665.15","N/A"
"132.42.61.77","35708","36.3.137.88","443","1","701","1","701","0","0","0.026807000","0.0000","N/A","N/A"
"148.162.201.230","39764","211.231.161.79","8880","1","943","1","943","0","0","0.026819000","0.0000","N/A","N/A"
"215.74.154.217","55336","92.238.90.92","1503","1","64","1","64","0","0","0.026839000","0.0000","N/A","N/A"
"188.98.33.184","34045","75.179.10.119","80","1","882","1","882","0","0","0.026872000","0.0000","N/A","N/A"
"132.244.220.146","44233","74.110.251.245","80","8","448","8","448","0","0","0.026902000","0.0005","7658119.66","N/A"
"25.94.25.221","2489","211.231.170.18","80","12","552","12","552","0","0","0.026924000","0.0051","870662.46","N/A"
"141.34.99.252","49897","211.231.171.101","80","26","1196","26","1196","0","0","0.026951000","0.0086","1112946.38","N/A"
"39.109.242.126","56193","181.175.224.85","443","1","56","0","0","1","56","0.026955000","0.0000","N/A","N/A"
"191.121.73.33","44711","29.22.12.198","80","1","1002","1","1002","0","0","0.026978000","0.0000","N/A","N/A"
"131.242.159.118","13363","232.60.179.232","80","10","14440","0","0","10","14440","0.026999000","0.0002","N/A","493675213.68"
"71.126.28.68","33801","181.175.235.116","80","4","4836","0","0","4","4836","0.027087000","0.0000","N/A","1682086956.52"
"58.57.201.166","43628","181.175.235.133","80","4","5732","0","0","4","5732","0.027090000","0.0000","N/A","2697411764.71"
"182.39.191.175","2347","215.74.123.119","80","1","50","0","0","1","50","0.027100000","0.0000","N/A","N/A"
"222.111.143.8","6165","211.231.171.69","182","2","92","2","92","0","0","0.027103000","0.0100","73548.52","N/A"
"70.135.1.99","60351","50.3.145.217","443","4","251","0","0","4","251","0.027104000","0.0001","N/A","20282828.28"
"71.248.19.83","33197","73.168.180.142","80","1","1504","0","0","1","1504","0.027114000","0.0000","N/A","N/A"
"36.225.208.229","8080","143.144.151.115","3444","2","92","0","0","2","92","0.027128000","0.0004","N/A","2073239.44"
"138.31.168.59","4423","176.205.189.53","80","2","787","2","787","0","0","0.027131000","0.0006","11283154.12","N/A"
"77.157.32.206","37226","232.60.179.223","80","6","8676","0","0","6","8676","0.027156000","0.0001","N/A","1261963636.36"
"232.60.179.129","64878","216.19.1.151","80","3","168","3","168","0","0","0.027199000","0.0000","38400000.00","N/A"
"43.173.249.244","60173","50.19.220.205","80","4","184","4","184","0","0","0.027278000","0.0004","3455399.06","N/A"
"95.151.10.115","64223","176.205.174.34","80","1","56","1","56","0","0","0.027279000","0.0000","N/A","N/A"
"135.15.228.6","56913","36.225.193.186","9944","2","112","2","112","0","0","0.027347000","0.0099","90450.23","N/A"
"80.101.8.67","59023","81.156.227.48","80","1","652","0","0","1","652","0.027364000","0.0000","N/A","N/A"
"71.126.3.240","33083","181.175.235.117","80","16","22401","0","0","16","22401","0.027388000","0.0001","N/A","1723153846.15"
"141.148.135.242","10805","36.3.67.192","80","3","4332","0","0","3","4332","0.027394000","0.0000","N/A","990171428.57"
"181.130.134.83","50752","73.97.113.42","1935","16","12284","0","0","16","12284","0.027406000","0.0091","N/A","10754213.18"
"128.10.129.223","34795","58.57.201.120","443","1","1181","1","1181","0","0","0.027419000","0.0000","N/A","N/A"
"50.173.123.219","50681","181.17.7.165","80","24","36096","0","0","24","36096","0.027424000","0.0098","N/A","29382173.38"
"209.3.220.136","56456","176.205.174.33","80","2","757","2","757","0","0","0.027433000","0.0027","2226470.59","N/A"
"232.60.179.179","47283","216.19.0.168","80","2","112","2","112","0","0","0.027454000","0.0001","11946666.67","N/A"
"58.57.201.133","46254","181.175.235.118","80","40","55604","0","0","40","55604","0.027465000","0.0004","N/A","1137677749.36"
"71.126.3.231","49336","181.175.235.132","80","4","5674","0","0","4","5674","0.027467000","0.0000","N/A","2521777777.78"
"75.226.253.220","50265","181.175.233.23","80","1","56","0","0","1","56","0.027470000","0.0000","N/A","N/A"
"243.242.140.225","58523","179.106.107.93","80","1","50","1","50","0","0","0.027479000","0.0000","N/A","N/A"
"68.11.38.212","55002","0.216.4.92","36158","1","68","1","68","0","0","0.027504000","0.0000","N/A","N/A"
"215.121.185.130","33207","232.58.180.10","443","1","658","1","658","0","0","0.027511000","0.0000","N/A","N/A"
"138.82.149.82","63868","36.86.34.210","80","1","64","1","64","0","0","0.027564000","0.0000","N/A","N/A"
"181.9.99.16","36667","232.42.155.181","443","1","397","0","0","1","397","0.027584000","0.0000","N/A","N/A"
"50.173.45.217","1237","73.97.123.251","80","1","52","0","0","1","52","0.027590000","0.0000","N/A","N/A"
"142.83.246.56","11396","36.3.67.191","443","1","56","0","0","1","56","0.027598000","0.0000","N/A","N/A"
"73.151.139.210","63627","76.121.206.81","80","1","46","0","0","1","46","0.027604000","0.0000","N/A","N/A"
"219.126.173.135","65419","58.57.201.199","80","1","1293","1","1293","0","0","0.027614000","0.0000","N/A","N/A"
"229.120.239.182","54025","21.247.33.141","8004","1","56","1","56","0","0","0.027627000","0.0000","N/A","N/A"
"73.235.205.183","20108","77.212.222.59","2852","2","100","0","0","2","100","0.027696000","0.0047","N/A","171342.90"
"142.70.233.199","61160","36.3.67.215","80","2","2992","0","0","2","2992","0.027716000","0.0000","N/A","1841230769.23"
"148.161.202.37","52346","191.235.251.124","80","1","662","1","662","0","0","0.027731000","0.0000","N/A","N/A"
"34.251.130.108","28342","186.237.209.132","80","1","46","0","0","1","46","0.027731000","0.0000","N/A","N/A"
"77.197.175.79","49582","211.231.164.197","8182","2","92","2","92","0","0","0.027735000","0.0005","1517525.77","N/A"
"159.252.235.50","64569","71.199.4.59","80","2","1664","2","1664","0","0","0.027750000","0.0000","6656000000.00","N/A"
"196.3.125.137","62554","176.205.174.34","80","2","92","2","92","0","0","0.027780000","0.0005","1383458.65","N/A"
"131.253.191.126","20390","232.60.179.168","80","2","2888","0","0","2","2888","0.027866000","0.0000","N/A","1540266666.67"
"74.110.251.208","53365","181.175.235.116","80","1","56","0","0","1","56","0.027867000","0.0000","N/A","N/A"
"95.90.114.113","51068","181.168.143.223","80","1","56","1","56","0","0","0.027887000","0.0000","N/A","N/A"
"48.3.191.55","49415","58.57.227.73","80","12","16826","0","0","12","16826","0.027914000","0.0044","N/A","30802746.00"
"146.24.150.207","52275","178.165.116.164","587","1","56","0","0","1","56","0.027954000","0.0000","N/A","N/A"
"88.158.148.110","49554","211.231.161.79","8081","1","46","1","46","0","0","0.027974000","0.0000","N/A","N/A"
"129.242.250.54","58303","178.61.254.226","9006","1","56","1","56","0","0","0.027984000","0.0000","N/A","N/A"
"198.240.47.226","6844","36.225.33.122","80","2","92","2","92","0","0","0.027985000","0.0000","40888888.89","N/A"
"131.243.27.148","16323","232.60.177.183","80","2","2880","0","0","2","2880","0.027999000","0.0000","N/A","1440000000.00"
"191.127.223.202","41919","73.97.14.86","1935","1","149","0","0","1","149","0.028018000","0.0000","N/A","N/A"
"41.83.174.251","46372","232.60.179.152","443","1","50","0","0","1","50","0.028021000","0.0000","N/A","N/A"
"75.226.168.18","34765","181.175.235.116","80","1","56","0","0","1","56","0.028037000","0.0000","N/A","N/A"
"181.175.224.36","39846","199.174.53.50","80","1","515","1","515","0","0","0.028049000","0.0000","N/A","N/A"
"50.46.1.240","52305","232.60.176.62","80","4","6016","0","0","4","6016","0.028059000","0.0000","N/A","1266526315.79"
"142.89.30.153","24823","36.3.67.215","80","2","2888","0","0","2","2888","0.028075000","0.0000","N/A","1925333333.33"
"75.232.63.178","55167","36.3.67.65","9050","1","56","0","0","1","56","0.028076000","0.0000","N/A","N/A"
"43.193.215.102","49943","211.231.161.62","182","2","92","2","92","0","0","0.028111000","0.0086","85891.00","N/A"
"215.121.185.130","33220","232.58.180.10","443","1","64","1","64","0","0","0.028133000","0.0000","N/A","N/A"
"76.220.202.120","18544","176.205.141.126","80","1","46","1","46","0","0","0.028144000","0.0000","N/A","N/A"
"36.99.105.183","63953","80.76.28.246","8000","1","52","1","52","0","0","0.028183000","0.0000","N/A","N/A"
"73.38.228.110","51848","77.73.50.46","80","1","50","0","0","1","50","0.028184000","0.0000","N/A","N/A"
"142.85.150.59","51268","232.60.179.222","80","2","2992","0","0","2","2992","0.028195000","0.0000","N/A","2176000000.00"
"181.0.181.106","46475","181.175.235.133","80","1","56","0","0","1","56","0.028207000","0.0000","N/A","N/A"
"72.157.218.225","53129","215.74.196.57","443","1","1373","0","0","1","1373","0.028231000","0.0000","N/A","N/A"
"76.141.55.110","50318","71.85.125.149","80","1","1050","1","1050","0","0","0.028237000","0.0000","N/A","N/A"
"231.177.131.103","2854","232.21.64.240","80","1","56","1","56","0","0","0.028243000","0.0000","N/A","N/A"
"140.202.16.185","1871","211.231.164.53","80","7","322","7","322","0","0","0.028253000","0.0074","348767.94","N/A"
"71.215.84.4","64887","181.175.233.22","80","1","56","0","0","1","56","0.028261000","0.0000","N/A","N/A"
"138.82.148.3","49355","36.3.137.115","443","2","757","2","757","0","0","0.028310000","0.0040","1512865.35","N/A"
"138.29.74.25","10582","176.205.174.33","80","1","46","1","46","0","0","0.028333000","0.0000","N/A","N/A"
"132.42.61.70","65110","36.3.137.88","443","1","56","1","56","0","0","0.028367000","0.0000","N/A","N/A"
"71.126.28.80","51822","181.175.224.85","443","1","56","0","0","1","56","0.028384000","0.0000","N/A","N/A"
"191.121.3.4","38470","132.42.42.156","9050","1","100","0","0","1","100","0.028401000","0.0000","N/A","N/A"
"148.186.154.67","60309","232.60.178.232","80","6","9024","0","0","6","9024","0.028438000","0.0001","N/A","586926829.27"
"14.17.144.76","51641","153.231.134.73","80","15","20910","0","0","15","20910","0.028450000","0.0008","N/A","222743009.32"
"219.126.173.133","49790","71.85.125.170","80","1","1282","1","1282","0","0","0.028463000","0.0000","N/A","N/A"
"43.30.195.148","4889","75.179.215.197","443","1","46","1","46","0","0","0.028464000","0.0000","N/A","N/A"
"80.101.42.42","19070","43.102.129.85","80","3","4005","0","0","3","4005","0.028468000","0.0000","N/A","1232307692.31"
"88.158.155.144","54528","211.231.161.79","8081","1","46","1","46","0","0","0.028472000","0.0000","N/A","N/A"
"142.89.42.81","12111","232.60.179.255","443","1","56","0","0","1","56","0.028489000","0.0000","N/A","N/A"
"73.228.135.95","8100","70.135.1.91","1299","1","226","1","226","0","0","0.028527000","0.0000","N/A","N/A"
"88.154.59.72","64337","211.231.161.138","1935","3","138","3","138","0","0","0.028562000","0.0012","955844.16","N/A"
"130.19.3.161","51636","211.231.169.234","80","10","460","10","460","0","0","0.028566000","0.0055","672514.62","N/A"
"141.26.35.147","51028","71.85.124.213","443","2","112","2","112","0","0","0.028568000","0.0000","N/A","N/A"
"232.58.57.154","61854","71.199.4.71","80","1","1226","1","1226","0","0","0.028576000","0.0000","N/A","N/A"
"151.238.152.194","45425","36.225.197.138","8080","1","56","1","56","0","0","0.028577000","0.0000","N/A","N/A"
"181.0.120.82","57416","181.175.235.132","80","20","27091","0","0","20","27091","0.028606000","0.0001","N/A","1747806451.61"
"181.131.210.10","60742","72.192.80.170","80","1","56","0","0","1","56","0.028622000","0.0000","N/A","N/A"
"232.60.178.250","44920","181.0.120.66","80","1","56","1","56","0","0","0.028626000","0.0000","N/A","N/A"
"43.30.171.94","19399","181.9.99.136","80","5","316","5","316","0","0","0.028645000","0.0000","50560000.00","N/A"
"70.135.1.22","63213","80.82.59.165","1935","22","29942","0","0","22","29942","0.028646000","0.0002","N/A","1019302127.66"
"74.110.251.206","62868","181.175.235.116","80","1","56","0","0","1","56","0.028659000","0.0000","N/A","N/A"
"141.147.135.0","2734","73.151.139.186","80","1","46","1","46","0","0","0.028687000","0.0000","N/A","N/A"
"88.193.127.33","13568","232.60.178.213","80","2","2888","0","0","2","2888","0.028701000","0.0000","N/A","2310400000.00"
"75.67.61.72","62863","129.42.3.217","49619","2","1548","2","1548","0","0","0.028766000","0.0000","12383999999.99","N/A"
"29.22.12.255","34067","181.175.233.22","80","2","124","0","0","2","124","0.028771000","0.0000","N/A","N/A"
"141.148.185.95","49597","232.60.178.64","443","1","56","0","0","1","56","0.028772000","0.0000","N/A","N/A"
"188.111.178.93","51199","36.3.67.192","80","1","56","0","0","1","56","0.028778000","0.0000","N/A","N/A"
"181.131.172.64","54301","73.228.135.206","80","3","3212","0","0","3","3212","0.028784000","0.0000","N/A","1713066666.67"
"58.57.201.205","42316","181.175.233.22","80","6","7771","0","0","6","7771","0.028785000","0.0000","N/A","3885500000.00"
"43.239.39.219","59844","211.231.170.117","80","3","138","3","138","0","0","0.028787000","0.0017","655192.88","N/A"
"229.198.182.255","3205","232.60.178.65","80","6","8809","0","0","6","8809","0.028792000","0.0001","N/A","634882882.88"
"135.139.122.247","1044","211.231.175.53","182","9","504","9","504","0","0","0.028827000","0.0060","666776.91","N/A"
"71.126.3.122","51235","50.3.145.217","80","26","30141","0","0","26","30141","0.028842000","0.0006","N/A","428291296.63"
"181.130.137.111","36230","130.17.47.4","4532","1","46","0","0","1","46","0.028851000","0.0000","N/A","N/A"
"232.60.177.157","51011","71.85.160.59","80","1","56","1","56","0","0","0.028856000","0.0000","N/A","N/A"
"92.163.79.53","34385","211.163.30.161","6667","1","50","0","0","1","50","0.028868000","0.0000","N/A","N/A"
"131.240.252.218","24439","232.60.177.164","443","1","50","0","0","1","50","0.028893000","0.0000","N/A","N/A"
"75.53.143.248","59061","178.60.245.113","5667","1","64","0","0","1","64","0.028893000","0.0000","N/A","N/A"
"135.210.244.192","2650","36.225.203.27","80","1","475","1","475","0","0","0.028905000","0.0000","N/A","N/A"
"150.2.190.18","13681","148.60.7.157","80","1","46","1","46","0","0","0.028922000","0.0000","N/A","N/A"
"232.60.178.69","54851","74.110.251.245","80","1","983","1","983","0","0","0.028980000","0.0000","N/A","N/A"
"142.70.209.114","12671","36.3.67.226","80","1","56","0","0","1","56","0.028988000","0.0000","N/A","N/A"
"71.215.84.14","42699","181.175.235.118","80","1","56","0","0","1","56","0.029004000","0.0000","N/A","N/A"
"142.81.192.4","3072","232.60.178.215","80","1","56","0","0","1","56","0.029008000","0.0000","N/A","N/A"
"36.3.67.185","51797","181.0.120.85","80","1","1042","1","1042","0","0","0.029045000","0.0000","N/A","N/A"
"58.57.179.234","34761","50.3.163.247","80","1","1047","1","1047","0","0","0.029099000","0.0000","N/A","N/A"
"50.19.161.245","8080","253.176.78.207","3921","2","92","0","0","2","92","0.029105000","0.0000","N/A","N/A"
"49.111.201.87","20556","73.151.139.180","443","1","56","1","56","0","0","0.029111000","0.0000","N/A","N/A"
"75.226.129.129","48407","71.199.4.119","80","1","994","1","994","0","0","0.029165000","0.0000","N/A","N/A"
"71.85.125.12","35627","232.72.0.83","80","1","56","0","0","1","56","0.029174000","0.0000","N/A","N/A"
"142.84.214.223","20163","232.60.178.66","80","2","2888","0","0","2","2888","0.029208000","0.0000","N/A","1925333333.33"
"150.215.166.191","50362","211.231.170.42","80","11","506","11","506","0","0","0.029222000","0.0017","2422501.50","N/A"
"141.34.4.0","57276","211.231.170.106","80","1","46","1","46","0","0","0.029241000","0.0000","N/A","N/A"
"131.12.161.212","60013","181.168.250.10","8080","6","276","6","276","0","0","0.029248000","0.0066","335868.57","N/A"
"43.173.249.75","54327","50.19.241.146","80","2","92","2","92","0","0","0.029260000","0.0000","736000000.00","N/A"
"142.89.188.116","50210","232.60.178.245","80","2","2992","0","0","2","2992","0.029275000","0.0000","N/A","2659555555.55"
"71.248.27.187","34474","191.235.251.124","80","2","850","2","850","0","0","0.029305000","0.0001","57142857.14","N/A"
"141.144.179.25","63097","232.60.177.202","443","1","50","0","0","1","50","0.029308000","0.0000","N/A","N/A"
"141.150.225.187","19240","74.116.201.121","80","3","204","3","204","0","0","0.029339000","0.0052","315484.25","N/A"
"142.85.165.231","15339","232.60.178.212","80","2","2888","0","0","2","2888","0.029376000","0.0000","N/A","1283555555.56"
"4.1.225.40","33569","72.192.80.170","80","3","4272","0","0","3","4272","0.029380000","0.0001","N/A","569600000.00"
"223.153.119.126","4563","181.168.161.170","80","1","46","1","46","0","0","0.029395000","0.0000","N/A","N/A"
"196.37.143.83","7585","211.231.175.194","182","1","56","1","56","0","0","0.029427000","0.0000","N/A","N/A"
"181.0.155.23","29429","178.213.231.108","1935","1","254","0","0","1","254","0.029433000","0.0000","N/A","N/A"
"141.144.78.52","52479","232.60.179.145","443","2","2834","0","0","2","2834","0.029461000","0.0000","N/A","2061090909.09"
"81.138.163.250","2636","215.74.123.119","80","1","309","0","0","1","309","0.029468000","0.0000","N/A","N/A"
"191.121.3.5","43529","25.1.127.98","9050","1","56","0","0","1","56","0.029503000","0.0000","N/A","N/A"
"10.205.228.244","37344","148.190.1.90","7000","1","104","1","104","0","0","0.029507000","0.0000","N/A","N/A"
"95.34.214.234","2626","211.231.164.53","80","1","46","1","46","0","0","0.029544000","0.0000","N/A","N/A"
"50.47.11.219","64969","36.3.67.169","443","1","56","0","0","1","56","0.029548000","0.0000","N/A","N/A"
"191.121.3.115","48170","181.255.157.115","9050","1","100","0","0","1","100","0.029550000","0.0000","N/A","N/A"
"95.241.125.247","62453","211.231.175.252","80","1","46","1","46","0","0","0.029557000","0.0000","N/A","N/A"
"215.74.154.217","49242","92.238.90.106","2800","1","64","1","64","0","0","0.029559000","0.0000","N/A","N/A"
"151.42.140.215","50108","232.60.178.118","443","9","10598","0","0","9","10598","0.029581000","0.0001","N/A","737252173.91"
"191.121.72.238","42594","74.110.251.148","80","1","1429","1","1429","0","0","0.029592000","0.0000","N/A","N/A"
"133.203.23.220","53614","191.121.3.142","80","1","56","1","56","0","0","0.029638000","0.0000","N/A","N/A"
"135.190.214.20","54537","211.231.175.234","8777","15","846","15","846","0","0","0.029638000","0.0035","1942594.72","N/A"
"50.19.254.133","8080","219.116.245.219","1269","8","368","0","0","8","368","0.029651000","0.0039","N/A","746829.02"
"142.89.131.27","3218","232.60.179.139","443","1","50","0","0","1","50","0.029678000","0.0000","N/A","N/A"
"232.60.177.220","51651","75.226.168.74","80","1","939","1","939","0","0","0.029680000","0.0000","N/A","N/A"
"232.60.178.206","36654","58.57.201.179","80","1","1026","1","1026","0","0","0.029725000","0.0000","N/A","N/A"
"232.60.178.218","51672","181.0.183.5","80","1","56","1","56","0","0","0.029731000","0.0000","N/A","N/A"
"43.173.250.31","45574","92.77.5.254","80","1","64","1","64","0","0","0.029739000","0.0000","N/A","N/A"
"181.9.98.107","64852","36.63.70.181","80","22","33088","0","0","22","33088","0.029744000","0.0013","N/A","196659732.54"
"131.245.148.91","50199","232.60.178.255","80","6","7530","0","0","6","7530","0.029749000","0.0018","N/A","32615051.43"
"58.57.201.237","63954","181.175.235.132","80","15","21739","0","0","15","21739","0.029767000","0.0001","N/A","2520463768.12"
"40.166.180.252","62633","176.205.189.53","80","1","46","1","46","0","0","0.029783000","0.0000","N/A","N/A"
"58.57.201.248","51671","181.175.235.118","80","47","64846","0","0","47","64846","0.029791000","0.0032","N/A","161811603.24"
"146.24.102.82","23469","216.115.86.57","80","1","1174","0","0","1","1174","0.029808000","0.0000","N/A","N/A"
"56.159.155.244","44663","215.121.151.233","80","1","64","0","0","1","64","0.029829000","0.0000","N/A","N/A"
"141.148.129.216","10967","232.60.177.202","443","1","649","0","0","1","649","0.029834000","0.0000","N/A","N/A"
"58.57.201.165","56798","181.175.235.133","80","1","56","0","0","1","56","0.029859000","0.0000","N/A","N/A"
"181.111.19.66","3144","179.120.39.142","80","1","46","0","0","1","46","0.029893000","0.0000","N/A","N/A"
"133.17.155.234","55045","81.134.50.197","25","1","56","1","56","0","0","0.029932000","0.0000","N/A","N/A"
"179.68.69.117","31407","191.250.205.154","8640","2","92","0","0","2","92","0.029969000","0.0038","N/A","193837.24"
"72.157.218.244","54866","211.188.19.162","443","1","64","0","0","1","64","0.030011000","0.0000","N/A","N/A"
"43.30.154.120","20954","75.179.215.202","443","1","56","1","56","0","0","0.030019000","0.0000","N/A","N/A"
"216.115.88.196","58132","179.231.238.130","92","1","417","1","417","0","0","0.030035000","0.0000","N/A","N/A"
"135.213.82.153","55215","36.86.220.211","80","2","389","2","389","0","0","0.030095000","0.0006","4963317.38","N/A"
"232.60.178.238","50236","71.126.28.232","80","2","112","2","112","0","0","0.030125000","0.0014","632321.81","N/A"
"21.247.33.178","1935","25.72.159.153","1297","1","523","0","0","1","523","0.030217000","0.0000","N/A","N/A"
"229.195.152.137","51783","36.225.47.154","8080","2","112","2","112","0","0","0.030218000","0.0059","150740.24","N/A"
"142.89.146.227","11972","232.60.179.187","443","1","56","0","0","1","56","0.030225000","0.0000","N/A","N/A"
"81.141.77.173","46464","92.52.238.166","443","1","56","1","56","0","0","0.030249000","0.0000","N/A","N/A"
"88.195.126.140","52748","232.60.179.144","80","5","6150","0","0","5","6150","0.030270000","0.0000","N/A","1261538461.54"
"216.42.62.80","61066","29.22.12.202","80","1","56","1","56","0","0","0.030272000","0.0000","N/A","N/A"
"36.102.13.173","65127","92.52.238.131","443","1","81","1","81","0","0","0.030277000","0.0000","N/A","N/A"
"41.45.147.221","46547","181.168.222.119","80","2","112","2","112","0","0","0.030278000","0.0022","405429.86","N/A"
"58.57.201.166","43635","181.175.235.133","80","1","56","0","0","1","56","0.030280000","0.0000","N/A","N/A"
"39.109.242.114","58252","181.175.224.85","443","1","56","0","0","1","56","0.030288000","0.0000","N/A","N/A"
"232.35.1.238","34213","73.151.139.244","80","3","168","3","168","0","0","0.030288000","0.0003","3895652.17","N/A"
"142.73.7.212","11065","232.60.178.212","443","2","2888","0","0","2","2888","0.030294000","0.0000","N/A","4620800000.00"
"36.3.67.162","35722","58.57.101.235","80","1","56","1","56","0","0","0.030300000","0.0000","N/A","N/A"
"232.0.243.210","15609","211.188.14.163","80","1","64","0","0","1","64","0.030311000","0.0000","N/A","N/A"
"135.243.17.137","50416","211.231.164.74","8182","7","322","7","322","0","0","0.030322000","0.0040","636206.47","N/A"
"95.164.166.146","63126","58.57.201.65","80","2","2018","2","2018","0","0","0.030332000","0.0000","8072000000.01","N/A"
"181.168.132.250","8080","131.51.231.78","1388","2","92","0","0","2","92","0.030346000","0.0041","N/A","178944.81"
"76.199.148.174","2361","203.249.97.233","445","1","68","1","68","0","0","0.030361000","0.0000","N/A","N/A"
"77.140.199.20","54560","211.231.161.62","182","2","92","2","92","0","0","0.030439000","0.0042","175238.10","N/A"
"90.17.251.250","50580","211.231.164.61","80","1","46","1","46","0","0","0.030460000","0.0000","N/A","N/A"
"189.143.226.92","54171","181.175.235.102","443","4","4139","0","0","4","4139","0.030461000","0.0001","N/A","303779816.51"
"232.35.1.189","60857","71.85.125.245","443","5","280","5","280","0","0","0.030578000","0.0006","3842195.54","N/A"
"71.184.186.237","38567","58.57.179.246","80","1","56","0","0","1","56","0.030584000","0.0000","N/A","N/A"
"219.223.147.57","64599","211.231.170.42","80","1","46","1","46","0","0","0.030585000","0.0000","N/A","N/A"
"128.131.83.203","57033","188.240.226.106","6881","1","1452","1","1452","0","0","0.030600000","0.0000","N/A","N/A"
"70.135.1.86","3250","181.175.237.236","443","1","46","0","0","1","46","0.030673000","0.0000","N/A","N/A"
"131.244.159.140","27819","36.3.67.214","80","1","1444","0","0","1","1444","0.030696000","0.0000","N/A","N/A"
"142.76.52.98","10179","232.60.179.225","443","1","1016","0","0","1","1016","0.030707000","0.0000","N/A","N/A"
"129.83.167.153","52269","211.231.170.42","80","3","138","3","138","0","0","0.030708000","0.0019","585987.26","N/A"
"138.82.149.141","56269","36.3.136.24","80","1","64","1","64","0","0","0.030729000","0.0000","N/A","N/A"
"229.225.223.243","27822","70.7.188.119","80","1","46","1","46","0","0","0.030738000","0.0000","N/A","N/A"
"229.225.223.243","27827","70.7.188.119","80","1","46","1","46","0","0","0.030739000","0.0000","N/A","N/A"
"229.225.223.243","27823","70.7.188.119","80","1","46","1","46","0","0","0.030743000","0.0000","N/A","N/A"
"231.100.218.5","42822","25.93.252.73","8625","1","46","0","0","1","46","0.030766000","0.0000","N/A","N/A"
"231.177.169.64","31805","232.21.93.39","443","1","56","1","56","0","0","0.030790000","0.0000","N/A","N/A"
"142.91.167.133","3699","232.60.178.109","80","11","14905","0","0","11","14905","0.030829000","0.0047","N/A","25156118.14"
"5.49.63.170","55377","128.131.151.214","888","2","837","0","0","2","837","0.030836000","0.0001","N/A","48172661.87"
"71.215.84.12","47120","181.175.235.118","80","2","124","0","0","2","124","0.030856000","0.0000","N/A","124000000.00"
"74.110.251.12","59512","181.175.235.133","80","1","56","0","0","1","56","0.030871000","0.0000","N/A","N/A"
"39.44.227.189","56311","75.226.129.134","80","1","68","0","0","1","68","0.030872000","0.0000","N/A","N/A"
"92.15.167.122","62524","215.74.220.188","443","5","5000","0","0","5","5000","0.030892000","0.0003","N/A","117647058.82"
"138.82.148.131","52186","36.3.137.106","443","1","701","1","701","0","0","0.030907000","0.0000","N/A","N/A"
"142.91.140.90","21982","232.60.178.100","443","2","2992","0","0","2","2992","0.030909000","0.0000","N/A","1496000000.00"
"58.57.179.255","48793","181.175.245.233","80","4","224","4","224","0","0","0.030922000","0.0001","17568627.45","N/A"
"141.61.72.134","50744","50.173.223.152","24194","2","138","2","138","0","0","0.030933000","0.0005","2025688.07","N/A"
"71.126.4.88","24887","181.175.231.233","80","5","1549","0","0","5","1549","0.030939000","0.0001","N/A","105914529.91"
"131.240.24.98","25240","232.60.178.232","443","1","1496","0","0","1","1496","0.030942000","0.0000","N/A","N/A"
"159.203.0.117","35616","92.52.238.172","80","1","46","1","46","0","0","0.030945000","0.0000","N/A","N/A"
"18.124.154.15","51369","140.230.15.92","443","3","150","0","0","3","150","0.030950000","0.0032","N/A","370141.89"
"222.188.226.230","18602","75.179.215.202","443","1","46","1","46","0","0","0.030958000","0.0000","N/A","N/A"
"142.91.130.131","12285","232.60.179.186","443","1","1444","0","0","1","1444","0.030981000","0.0000","N/A","N/A"
"191.121.3.62","40739","218.37.69.1","9050","5","6139","0","0","5","6139","0.031008000","0.0000","N/A","1259282051.28"
"41.144.40.64","15111","71.91.105.138","25","1","50","1","50","0","0","0.031016000","0.0000","N/A","N/A"
"72.157.218.245","50253","211.188.19.162","443","1","64","0","0","1","64","0.031017000","0.0000","N/A","N/A"
"141.147.129.1","50014","36.3.67.189","443","1","1484","0","0","1","1484","0.031026000","0.0000","N/A","N/A"
"75.226.167.230","37368","80.90.153.198","80","3","1902","0","0","3","1902","0.031074000","0.0024","N/A","6466638.33"
"77.121.3.71","53855","36.86.42.68","15203","1","62","1","62","0","0","0.031129000","0.0000","N/A","N/A"
"231.85.73.82","58147","73.228.140.122","1935","6","7207","0","0","6","7207","0.031132000","0.0000","N/A","1406243902.44"
"232.56.226.16","42637","58.57.179.181","80","1","56","0","0","1","56","0.031165000","0.0000","N/A","N/A"
"232.60.178.76","40100","58.57.101.219","80","1","56","1","56","0","0","0.031173000","0.0000","N/A","N/A"
"142.85.101.255","13531","232.60.179.138","443","1","1444","0","0","1","1444","0.031191000","0.0000","N/A","N/A"
"142.89.66.224","13148","36.3.67.170","80","5","7066","0","0","5","7066","0.031211000","0.0000","N/A","1153632653.06"
"140.216.214.11","51385","211.231.161.79","8081","4","184","4","184","0","0","0.031218000","0.0019","789276.14","N/A"
"48.34.148.255","3014","63.212.119.83","80","1","52","0","0","1","52","0.031232000","0.0000","N/A","N/A"
"215.74.154.217","54516","92.238.90.104","1044","1","64","1","64","0","0","0.031266000","0.0000","N/A","N/A"
"211.248.119.53","38605","153.231.133.204","25","1","56","0","0","1","56","0.031271000","0.0000","N/A","N/A"
"232.23.227.4","36526","76.141.55.108","9050","1","100","0","0","1","100","0.031297000","0.0000","N/A","N/A"
"232.60.178.113","56625","181.0.183.73","80","2","112","2","112","0","0","0.031394000","0.0001","10541176.47","N/A"
"137.175.140.0","51808","148.163.27.68","80","1","46","1","46","0","0","0.031404000","0.0000","N/A","N/A"
"231.69.164.180","57608","77.110.146.137","12442","1","56","0","0","1","56","0.031423000","0.0000","N/A","N/A"
"77.140.205.138","65403","179.180.109.166","18011","1","56","1","56","0","0","0.031423000","0.0000","N/A","N/A"
"231.177.169.235","45975","232.19.58.209","443","1","68","1","68","0","0","0.031445000","0.0000","N/A","N/A"
"135.240.191.57","56855","211.231.171.101","80","1","46","1","46","0","0","0.031459000","0.0000","N/A","N/A"
"95.66.95.246","2627","211.231.170.42","80","2","92","2","92","0","0","0.031461000","0.0054","137287.82","N/A"
"58.57.201.140","59562","181.175.235.132","80","1","56","0","0","1","56","0.031479000","0.0000","N/A","N/A"
"142.85.218.245","3009","36.3.67.226","443","2","2992","0","0","2","2992","0.031505000","0.0000","N/A","1595733333.33"
"41.83.176.99","28783","73.168.180.141","80","1","1404","0","0","1","1404","0.031506000","0.0000","N/A","N/A"
"138.27.177.140","15714","232.60.178.101","443","3","168","0","0","3","168","0.031535000","0.0046","N/A","292428.20"
"132.42.43.116","60531","211.201.234.170","80","2","92","2","92","0","0","0.031535000","0.0037","197266.15","N/A"
"216.19.1.114","53833","181.175.235.132","80","1","56","0","0","1","56","0.031548000","0.0000","N/A","N/A"
"232.31.17.92","44721","58.57.100.117","443","1","637","1","637","0","0","0.031587000","0.0000","N/A","N/A"
"71.215.84.114","36045","181.175.235.133","80","1","56","0","0","1","56","0.031589000","0.0000","N/A","N/A"
"147.159.210.51","49475","148.163.34.10","8080","1","56","1","56","0","0","0.031605000","0.0000","N/A","N/A"
"142.70.245.148","10683","232.60.179.187","443","6","7270","0","0","6","7270","0.031617000","0.0041","N/A","14206155.35"
"77.252.136.34","16988","232.60.177.149","80","4","3612","0","0","4","3612","0.031663000","0.0015","N/A","19643779.74"
"88.196.122.158","61309","36.225.197.138","8080","1","56","1","56","0","0","0.031722000","0.0000","N/A","N/A"
"131.243.56.50","27200","232.60.179.225","443","1","1016","0","0","1","1016","0.031722000","0.0000","N/A","N/A"
"139.143.85.241","4643","211.231.169.234","80","8","368","8","368","0","0","0.031724000","0.0024","1217031.83","N/A"
"142.89.121.179","2340","232.60.177.164","443","3","3225","0","0","3","3225","0.031783000","0.0000","N/A","1842857142.86"
"50.22.65.6","47605","215.75.216.25","80","1","56","0","0","1","56","0.031807000","0.0000","N/A","N/A"
"133.39.136.205","49749","157.121.255.187","8000","1","56","1","56","0","0","0.031856000","0.0000","N/A","N/A"
"142.73.42.96","49347","232.60.178.229","80","1","1496","0","0","1","1496","0.031876000","0.0000","N/A","N/A"
"232.60.178.104","64443","74.110.251.203","80","1","56","1","56","0","0","0.031886000","0.0000","N/A","N/A"
"29.22.12.255","49550","181.175.233.22","80","1","56","0","0","1","56","0.031903000","0.0000","N/A","N/A"
"58.57.201.231","37679","181.175.235.116","80","1","56","0","0","1","56","0.031933000","0.0000","N/A","N/A"
"74.110.251.28","58672","181.175.235.117","80","67","94438","0","0","67","94438","0.031961000","0.0005","N/A","1425479245.28"
"141.147.151.159","50035","232.60.179.187","443","1","1484","0","0","1","1484","0.031973000","0.0000","N/A","N/A"
"211.188.81.114","55597","75.179.10.112","443","1","478","1","478","0","0","0.031976000","0.0000","N/A","N/A"
"129.123.118.164","54952","211.231.164.237","8182","2","92","2","92","0","0","0.031997000","0.0006","1264604.81","N/A"
"218.239.134.124","51246","178.61.241.221","443","1","46","1","46","0","0","0.032010000","0.0000","N/A","N/A"
"43.30.144.51","27061","58.57.200.97","443","1","64","1","64","0","0","0.032020000","0.0000","N/A","N/A"
"142.91.199.181","18456","232.60.178.111","80","1","1444","0","0","1","1444","0.032045000","0.0000","N/A","N/A"
"150.150.94.217","62141","211.231.161.181","80","4","224","4","224","0","0","0.032059000","0.0006","3132867.13","N/A"
"58.57.201.230","58750","181.175.235.133","80","1","56","0","0","1","56","0.032077000","0.0000","N/A","N/A"
"95.209.191.244","1929","211.231.164.53","80","1","46","1","46","0","0","0.032088000","0.0000","N/A","N/A"
"36.225.139.101","8080","131.51.231.78","1366","2","92","0","0","2","92","0.032092000","0.0039","N/A","186470.74"
"140.251.118.32","53023","211.231.164.53","80","4","256","4","256","0","0","0.032095000","0.0000","89043478.26","N/A"
"219.126.173.158","49217","71.85.125.229","80","1","56","1","56","0","0","0.032105000","0.0000","N/A","N/A"
"36.3.67.207","49798","58.57.201.254","80","2","112","2","112","0","0","0.032157000","0.0000","64000000.00","N/A"
"36.62.99.254","43250","58.57.179.214","80","1","366","0","0","1","366","0.032177000","0.0000","N/A","N/A"
"232.60.179.178","38064","181.0.142.88","80","1","56","1","56","0","0","0.032183000","0.0000","N/A","N/A"
"92.163.79.53","34388","211.163.30.161","6667","1","50","0","0","1","50","0.032189000","0.0000","N/A","N/A"
"131.247.62.187","1470","36.3.67.168","80","3","4488","0","0","3","4488","0.032192000","0.0036","N/A","9847504.11"
"138.82.148.115","62936","71.199.4.97","80","1","56","1","56","0","0","0.032195000","0.0000","N/A","N/A"
"94.250.116.6","37518","36.225.185.42","80","4","184","4","184","0","0","0.032205000","0.0003","4826229.51","N/A"
"92.163.79.53","34387","211.163.30.161","6667","1","50","0","0","1","50","0.032229000","0.0000","N/A","N/A"
"131.107.143.232","51853","176.205.174.41","80","1","56","1","56","0","0","0.032234000","0.0000","N/A","N/A"
"36.3.67.132","57454","74.110.251.194","80","1","808","1","808","0","0","0.032234000","0.0000","N/A","N/A"
"88.195.160.53","26659","36.3.67.180","80","1","56","0","0","1","56","0.032239000","0.0000","N/A","N/A"
"133.203.23.197","64808","58.57.201.161","80","3","168","3","168","0","0","0.032248000","0.0003","4650519.03","N/A"
"92.247.113.145","51270","36.3.67.227","443","9","12672","0","0","9","12672","0.032259000","0.0018","N/A","55578947.37"
"90.127.6.181","1849","232.58.62.5","445","1","52","1","52","0","0","0.032262000","0.0000","N/A","N/A"
"177.96.201.202","1099","211.188.246.124","80","1","52","0","0","1","52","0.032327000","0.0000","N/A","N/A"
"58.57.201.167","56957","181.175.233.23","80","11","15167","0","0","11","15167","0.032353000","0.0001","N/A","947937500.00"
"153.245.218.174","4571","192.143.108.104","445","1","52","1","52","0","0","0.032366000","0.0000","N/A","N/A"
"232.60.179.240","59252","181.0.142.22","80","7","392","7","392","0","0","0.032369000","0.0004","8145454.55","N/A"
"135.248.57.148","49344","231.85.27.224","32840","1","46","1","46","0","0","0.032383000","0.0000","N/A","N/A"
"142.85.89.55","10518","232.60.178.73","80","1","1444","0","0","1","1444","0.032385000","0.0000","N/A","N/A"
"88.193.125.140","15041","232.60.178.232","80","1","1444","0","0","1","1444","0.032414000","0.0000","N/A","N/A"
"75.205.145.254","30439","73.151.138.254","80","1","50","1","50","0","0","0.032430000","0.0000","N/A","N/A"
"131.240.253.195","13944","232.60.177.226","80","2","2862","0","0","2","2862","0.032449000","0.0000","N/A","2081454545.45"
"159.203.76.53","4203","92.52.238.166","443","1","93","1","93","0","0","0.032461000","0.0000","N/A","N/A"
"70.135.1.89","49298","50.3.145.217","443","1","50","0","0","1","50","0.032467000","0.0000","N/A","N/A"
"216.42.62.174","52923","74.110.251.134","80","7","392","7","392","0","0","0.032469000","0.0046","675134.55","N/A"
"147.158.7.81","33206","50.19.161.202","8080","1","56","1","56","0","0","0.032492000","0.0000","N/A","N/A"
"179.158.144.113","7802","180.68.140.89","25","1","77","1","77","0","0","0.032493000","0.0000","N/A","N/A"
"43.198.108.75","49954","211.231.171.101","80","5","230","5","230","0","0","0.032497000","0.0046","400086.98","N/A"
"131.245.171.191","55439","36.3.67.182","443","1","56","0","0","1","56","0.032530000","0.0000","N/A","N/A"
"72.157.218.242","65184","211.188.19.162","443","4","261","0","0","4","261","0.032564000","0.0008","N/A","2676923.08"
"232.60.179.176","44532","58.57.101.212","80","1","56","1","56","0","0","0.032588000","0.0000","N/A","N/A"
"232.58.57.175","36505","71.85.125.187","80","4","224","4","224","0","0","0.032616000","0.0001","22123456.79","N/A"
"138.30.218.146","23952","176.205.189.53","80","1","46","1","46","0","0","0.032617000","0.0000","N/A","N/A"
"142.81.153.57","10973","232.60.179.222","80","2","2888","0","0","2","2888","0.032634000","0.0000","N/A","1540266666.67"
"72.157.218.210","60627","211.188.19.162","443","1","115","0","0","1","115","0.032660000","0.0000","N/A","N/A"
"138.27.211.73","27787","176.205.189.82","80","1","56","1","56","0","0","0.032682000","0.0000","N/A","N/A"
"231.178.19.244","54878","231.166.206.94","80","1","64","1","64","0","0","0.032738000","0.0000","N/A","N/A"
"154.0.214.168","49436","211.231.164.253","8182","1","46","1","46","0","0","0.032748000","0.0000","N/A","N/A"
"73.151.139.110","45903","138.82.153.228","80","33","48664","0","0","33","48664","0.032761000","0.0004","N/A","963643564.36"
"58.57.100.30","39243","58.57.179.193","80","1","1327","0","0","1","1327","0.032770000","0.0000","N/A","N/A"
"74.110.251.207","57679","181.175.235.133","80","53","74234","0","0","53","74234","0.032775000","0.0003","N/A","1706528735.63"
"222.6.182.96","55412","29.22.13.94","80","1","56","1","56","0","0","0.032782000","0.0000","N/A","N/A"
"89.7.31.71","61426","211.231.161.207","182","9","504","9","504","0","0","0.032789000","0.0035","1161290.32","N/A"
"135.240.34.232","54014","36.86.243.137","443","1","46","1","46","0","0","0.032789000","0.0000","N/A","N/A"
"50.19.133.98","8080","83.159.102.254","2707","2","92","0","0","2","92","0.032806000","0.0016","N/A","466413.18"
"71.248.18.17","39560","73.168.182.201","80","9","13536","0","0","9","13536","0.032808000","0.0007","N/A","148339726.03"
"131.247.57.24","20088","232.60.178.109","443","4","5776","0","0","4","5776","0.032818000","0.0037","N/A","12384883.41"
"71.126.4.93","14065","50.3.145.217","80","1","64","0","0","1","64","0.032846000","0.0000","N/A","N/A"
"231.187.73.230","59544","232.38.110.85","80","12","17088","0","0","12","17088","0.032850000","0.0006","N/A","239831578.95"
"204.72.62.232","15317","232.21.65.39","80","1","46","1","46","0","0","0.032872000","0.0000","N/A","N/A"
"151.255.168.184","52635","181.97.3.178","80","2","160","2","160","0","0","0.032879000","0.0011","1209829.87","N/A"
"70.135.1.23","9395","181.175.237.236","443","1","50","0","0","1","50","0.032902000","0.0000","N/A","N/A"
"181.0.142.16","33847","181.175.233.23","80","32","45296","0","0","32","45296","0.032915000","0.0002","N/A","1877554404.15"
"148.162.201.230","43379","211.231.161.79","8880","1","56","1","56","0","0","0.032937000","0.0000","N/A","N/A"
"71.126.28.114","42023","181.175.231.233","443","1","56","0","0","1","56","0.032942000","0.0000","N/A","N/A"
"142.81.104.174","3000","232.60.179.145","443","2","1066","0","0","2","1066","0.032956000","0.0038","N/A","2238907.85"
"229.136.159.230","11632","176.205.189.53","80","1","60","1","60","0","0","0.032956000","0.0000","N/A","N/A"
"181.99.68.81","2334","92.52.238.166","443","1","81","1","81","0","0","0.032974000","0.0000","N/A","N/A"
"232.31.17.115","48427","71.85.125.137","80","3","168","3","168","0","0","0.033012000","0.0001","14769230.77","N/A"
"159.183.98.117","57908","82.150.215.113","80","1","541","0","0","1","541","0.033015000","0.0000","N/A","N/A"
"90.12.251.143","63757","211.231.170.42","80","6","276","6","276","0","0","0.033025000","0.0037","596756.76","N/A"
"71.126.3.204","38842","181.175.235.117","80","1","56","0","0","1","56","0.033032000","0.0000","N/A","N/A"
"90.225.156.217","38182","70.7.191.81","80","1","56","1","56","0","0","0.033039000","0.0000","N/A","N/A"
"142.89.111.207","15257","232.60.178.72","443","2","2888","0","0","2","2888","0.033061000","0.0031","N/A","7557736.34"
"232.60.179.166","64271","71.215.84.89","80","1","56","1","56","0","0","0.033083000","0.0000","N/A","N/A"
"181.0.120.101","63471","181.175.235.118","80","1","56","0","0","1","56","0.033097000","0.0000","N/A","N/A"
"131.249.183.127","1138","232.60.177.216","443","1","1329","0","0","1","1329","0.033110000","0.0000","N/A","N/A"
"70.135.1.90","57465","181.175.237.236","443","2","92","0","0","2","92","0.033129000","0.0001","N/A","7747368.42"
"138.31.255.176","1047","73.151.139.186","80","1","46","1","46","0","0","0.033137000","0.0000","N/A","N/A"
"142.89.165.109","49403","36.3.67.191","80","1","1371","0","0","1","1371","0.033180000","0.0000","N/A","N/A"
"189.202.83.201","47170","81.87.82.39","80","1","56","1","56","0","0","0.033181000","0.0000","N/A","N/A"
"141.151.163.18","49802","71.85.125.202","80","2","112","2","112","0","0","0.033218000","0.0014","636815.92","N/A"
"142.85.200.210","52738","232.60.178.111","80","1","56","0","0","1","56","0.033246000","0.0000","N/A","N/A"
"71.215.84.29","46705","181.175.235.118","80","1","56","0","0","1","56","0.033254000","0.0000","N/A","N/A"
"222.6.126.99","50790","71.85.125.138","443","2","112","2","112","0","0","0.033258000","0.0000","18285714.29","N/A"
"179.158.147.118","52813","179.231.228.105","5647","1","46","1","46","0","0","0.033260000","0.0000","N/A","N/A"
"74.110.251.243","42472","181.175.235.118","80","1","56","0","0","1","56","0.033308000","0.0000","N/A","N/A"
"196.59.163.151","59765","176.205.174.34","80","1","46","1","46","0","0","0.033353000","0.0000","N/A","N/A"
"131.243.98.23","23265","232.60.179.145","443","1","52","0","0","1","52","0.033358000","0.0000","N/A","N/A"
"135.84.65.220","43046","211.231.164.53","80","2","112","2","112","0","0","0.033365000","0.0003","3555555.56","N/A"
"159.252.235.28","51764","75.226.167.212","80","1","56","1","56","0","0","0.033377000","0.0000","N/A","N/A"
"43.212.83.95","49370","211.231.170.122","80","7","322","7","322","0","0","0.033412000","0.0023","1120000.00","N/A"
"232.60.178.206","44437","58.57.201.162","80","1","1050","1","1050","0","0","0.033462000","0.0000","N/A","N/A"
"43.208.241.117","63904","211.231.161.221","80","2","92","2","92","0","0","0.033464000","0.0035","208735.11","N/A"
"142.91.91.34","53204","232.60.178.255","80","1","1496","0","0","1","1496","0.033474000","0.0000","N/A","N/A"
"71.126.4.14","28949","181.175.237.236","80","2","2684","0","0","2","2684","0.033478000","0.0000","N/A","21471999999.98"
"43.173.249.66","38209","36.225.82.10","80","5","230","5","230","0","0","0.033489000","0.0003","6153846.15","N/A"
"78.249.116.57","49693","232.60.178.247","443","6","8877","0","0","6","8877","0.033495000","0.0001","N/A","1127238095.24"
"83.229.80.59","58366","189.126.79.225","54633","1","56","1","56","0","0","0.033508000","0.0000","N/A","N/A"
"141.150.231.250","28233","232.60.178.64","443","1","1444","0","0","1","1444","0.033514000","0.0000","N/A","N/A"
"131.243.39.50","1366","232.60.177.209","443","1","50","0","0","1","50","0.033523000","0.0000","N/A","N/A"
"131.244.109.128","18718","232.60.178.254","443","2","2888","0","0","2","2888","0.033525000","0.0035","N/A","6532089.34"
"39.109.242.119","18508","181.175.224.85","443","1","64","0","0","1","64","0.033539000","0.0000","N/A","N/A"
"77.238.69.130","51691","36.225.140.194","80","1","64","1","64","0","0","0.033540000","0.0000","N/A","N/A"
"72.157.218.253","61813","215.75.216.193","443","1","81","0","0","1","81","0.033553000","0.0000","N/A","N/A"
"132.42.61.86","51865","36.3.137.96","443","1","701","1","701","0","0","0.033572000","0.0000","N/A","N/A"
"80.82.59.86","1935","39.31.112.24","1735","9","11078","9","11078","0","0","0.033627000","0.0001","1150961038.96","N/A"
"198.245.121.235","54070","75.179.10.106","80","1","56","1","56","0","0","0.033676000","0.0000","N/A","N/A"
"83.77.24.180","56275","14.167.111.134","443","1","52","1","52","0","0","0.033686000","0.0000","N/A","N/A"
"181.175.237.240","39685","199.174.53.50","80","1","489","1","489","0","0","0.033706000","0.0000","N/A","N/A"
"95.156.144.122","54779","176.205.174.34","80","1","46","1","46","0","0","0.033733000","0.0000","N/A","N/A"
"142.67.109.202","45777","36.3.67.201","80","1","50","0","0","1","50","0.033738000","0.0000","N/A","N/A"
"141.35.12.123","60784","176.205.141.126","80","1","56","1","56","0","0","0.033760000","0.0000","N/A","N/A"
"36.107.253.105","65490","64.194.237.130","25565","2","260","2","260","0","0","0.033777000","0.0004","5402597.40","N/A"
"200.22.6.89","47145","73.168.177.160","80","4","6016","0","0","4","6016","0.033781000","0.0003","N/A","173747292.42"
"180.130.82.206","62551","92.52.238.172","443","1","129","1","129","0","0","0.033786000","0.0000","N/A","N/A"
"39.109.242.118","37618","181.175.224.85","443","1","56","0","0","1","56","0.033798000","0.0000","N/A","N/A"
"6.168.23.243","43093","58.57.201.162","80","7","392","7","392","0","0","0.033809000","0.0007","4765957.45","N/A"
"231.87.77.51","59077","135.247.136.158","51619","1","46","0","0","1","46","0.033816000","0.0000","N/A","N/A"
"138.154.174.234","49486","180.238.47.185","80","1","46","0","0","1","46","0.033825000","0.0000","N/A","N/A"
"129.121.34.33","52276","211.231.169.234","80","1","56","1","56","0","0","0.033841000","0.0000","N/A","N/A"
"71.215.84.114","36443","181.175.235.133","80","1","56","0","0","1","56","0.033874000","0.0000","N/A","N/A"
"71.126.3.240","43432","181.175.235.117","80","1","56","0","0","1","56","0.033886000","0.0000","N/A","N/A"
"131.246.133.40","11976","232.60.177.182","443","1","50","0","0","1","50","0.033899000","0.0000","N/A","N/A"
"43.173.249.70","43885","181.168.255.170","80","11","506","11","506","0","0","0.033909000","0.0003","13768707.48","N/A"
"181.168.230.74","8080","77.82.185.53","2021","1","46","0","0","1","46","0.033915000","0.0000","N/A","N/A"
"177.18.26.73","55800","181.175.237.236","80","3","1793","0","0","3","1793","0.033925000","0.0000","N/A","377473684.21"
"181.9.99.112","43226","181.175.233.23","80","1","56","0","0","1","56","0.033925000","0.0000","N/A","N/A"
"141.24.42.82","56915","0.230.232.127","10950","1","46","1","46","0","0","0.033929000","0.0000","N/A","N/A"
"81.63.210.79","60797","215.121.161.174","80","1","56","0","0","1","56","0.033945000","0.0000","N/A","N/A"
"131.249.140.123","50695","36.3.67.202","443","10","14040","0","0","10","14040","0.033989000","0.0001","N/A","1021090909.09"
"141.150.207.32","24174","232.60.179.163","80","1","50","0","0","1","50","0.033990000","0.0000","N/A","N/A"
"191.121.72.66","57778","71.85.125.138","80","1","64","1","64","0","0","0.034026000","0.0000","N/A","N/A"
"138.82.148.86","42664","71.199.4.97","80","5","280","5","280","0","0","0.034079000","0.0001","18360655.74","N/A"
"142.83.96.250","50598","232.60.177.218","443","1","56","0","0","1","56","0.034080000","0.0000","N/A","N/A"
"138.82.148.113","59042","71.199.4.71","80","2","112","2","112","0","0","0.034110000","0.0001","17230769.23","N/A"
"132.42.42.207","49129","71.199.4.41","80","13","728","13","728","0","0","0.034138000","0.0015","3935135.14","N/A"
"50.173.30.171","52520","64.172.152.33","80","4","6016","0","0","4","6016","0.034157000","0.0000","N/A","1458424242.42"
"135.251.202.183","50544","211.231.171.69","182","1","46","1","46","0","0","0.034168000","0.0000","N/A","N/A"
"141.34.4.0","57271","211.231.170.106","80","1","46","1","46","0","0","0.034192000","0.0000","N/A","N/A"
"130.26.225.6","65482","211.231.170.42","80","1","46","1","46","0","0","0.034193000","0.0000","N/A","N/A"
"142.89.248.35","49466","232.60.179.123","80","2","2992","0","0","2","2992","0.034196000","0.0000","N/A","11967999999.99"
"75.179.192.161","47511","181.175.235.116","80","8","11450","0","0","8","11450","0.034199000","0.0000","N/A","2862500000.00"
"232.60.178.127","56951","181.0.120.26","80","1","990","1","990","0","0","0.034226000","0.0000","N/A","N/A"
"131.244.172.115","50279","232.60.179.223","443","2","2992","0","0","2","2992","0.034227000","0.0000","N/A","1994666666.67"
"71.126.3.210","41275","181.175.230.104","443","1","56","0","0","1","56","0.034259000","0.0000","N/A","N/A"
"231.177.168.73","25282","232.21.93.39","443","1","56","1","56","0","0","0.034277000","0.0000","N/A","N/A"
"223.171.159.252","43014","232.60.177.219","80","1","56","0","0","1","56","0.034291000","0.0000","N/A","N/A"
"129.80.141.107","16695","211.231.164.53","80","6","276","6","276","0","0","0.034299000","0.0006","3532800.00","N/A"
"142.91.18.87","21211","232.60.178.118","80","3","4332","0","0","3","4332","0.034308000","0.0019","N/A","18259220.23"
"215.74.154.217","36531","92.238.90.40","80","1","64","1","64","0","0","0.034338000","0.0000","N/A","N/A"
"179.158.147.118","56560","179.231.228.70","5647","3","177","3","177","0","0","0.034357000","0.0014","1025343.95","N/A"
"43.25.145.173","56306","176.205.174.34","80","2","606","2","606","0","0","0.034379000","0.0023","2092360.81","N/A"
"179.158.147.118","54719","179.231.228.114","5647","3","177","3","177","0","0","0.034391000","0.0008","1796954.31","N/A"
"83.53.194.158","63546","81.87.82.39","80","1","46","1","46","0","0","0.034395000","0.0000","N/A","N/A"
"179.158.147.118","43613","179.231.228.98","5647","3","177","3","177","0","0","0.034405000","0.0004","3339622.64","N/A"
"43.247.139.210","63596","211.231.164.53","80","6","336","6","336","0","0","0.034463000","0.0006","4517647.06","N/A"
"141.147.160.101","50140","176.205.189.53","80","1","56","1","56","0","0","0.034463000","0.0000","N/A","N/A"
"229.121.216.116","56880","181.168.178.26","8080","3","138","3","138","0","0","0.034468000","0.0001","19368421.05","N/A"
"232.60.178.218","33460","71.126.28.168","80","4","224","4","224","0","0","0.034472000","0.0000","36571428.57","N/A"
"137.173.255.125","3875","192.158.93.134","445","1","52","1","52","0","0","0.034480000","0.0000","N/A","N/A"
"58.57.101.198","55603","181.175.233.22","80","12","17180","0","0","12","17180","0.034552000","0.0001","N/A","1462127659.57"
"36.217.35.231","60088","74.110.255.171","143","1","206","1","206","0","0","0.034597000","0.0000","N/A","N/A"
"71.126.4.76","50302","181.175.237.236","80","2","112","0","0","2","112","0.034615000","0.0000","N/A","298666666.67"
"142.91.120.28","25322","232.60.178.117","80","1","56","0","0","1","56","0.034625000","0.0000","N/A","N/A"
"141.148.144.138","29182","81.134.50.195","25","2","96","2","96","0","0","0.034640000","0.0015","521031.21","N/A"
"41.17.210.17","44955","181.168.169.253","80","1","46","1","46","0","0","0.034657000","0.0000","N/A","N/A"
"75.226.167.153","48907","181.175.233.22","80","1","56","0","0","1","56","0.034692000","0.0000","N/A","N/A"
"133.203.14.170","60580","232.30.102.143","80","14","784","14","784","0","0","0.034719000","0.0013","4865787.43","N/A"
"143.76.39.33","43282","224.243.33.1","443","1","56","1","56","0","0","0.034734000","0.0000","N/A","N/A"
"15.173.160.55","41499","14.167.111.113","80","1","56","1","56","0","0","0.034735000","0.0000","N/A","N/A"
"73.172.62.141","63867","92.71.197.161","1935","5","3295","0","0","5","3295","0.034761000","0.0017","N/A","15245806.82"
"215.75.140.49","37578","75.179.10.116","443","4","410","4","410","0","0","0.034775000","0.0008","4189016.60","N/A"
"58.57.154.144","39162","58.57.100.53","80","3","168","3","168","0","0","0.034796000","0.0005","2545454.55","N/A"
"74.110.251.12","59560","181.175.235.133","80","27","37981","0","0","27","37981","0.034798000","0.0001","N/A","2025653333.33"
"141.34.140.55","50798","176.205.174.33","80","1","52","1","52","0","0","0.034838000","0.0000","N/A","N/A"
"143.164.134.38","53677","176.205.174.41","80","1","56","1","56","0","0","0.034842000","0.0000","N/A","N/A"
"43.30.159.120","64466","181.9.99.182","443","1","56","1","56","0","0","0.034857000","0.0000","N/A","N/A"
"232.23.227.25","42553","138.82.149.8","9050","1","100","0","0","1","100","0.034858000","0.0000","N/A","N/A"
"28.34.217.133","56262","76.157.221.205","14396","1","56","0","0","1","56","0.034910000","0.0000","N/A","N/A"
"142.91.53.141","4034","36.3.67.144","80","1","56","0","0","1","56","0.034937000","0.0000","N/A","N/A"
"231.177.166.241","58192","232.21.82.177","80","1","56","1","56","0","0","0.034940000","0.0000","N/A","N/A"
"142.91.246.250","12254","232.60.177.189","80","1","764","0","0","1","764","0.034955000","0.0000","N/A","N/A"
"181.0.120.30","61498","181.175.233.22","80","7","9387","0","0","7","9387","0.034965000","0.0001","N/A","1472470588.24"
"43.255.47.109","59684","75.179.18.192","80","1","56","1","56","0","0","0.034985000","0.0000","N/A","N/A"
"80.100.40.33","54755","92.166.241.218","443","3","2666","0","0","3","2666","0.034994000","0.0004","N/A","55686684.07"
"140.192.202.69","60285","211.231.170.42","80","10","460","10","460","0","0","0.034994000","0.0023","1626159.96","N/A"
"58.119.153.253","45782","216.115.86.54","80","1","56","0","0","1","56","0.035008000","0.0000","N/A","N/A"
"232.60.179.240","44695","58.57.201.148","80","1","976","1","976","0","0","0.035016000","0.0000","N/A","N/A"
"91.98.219.4","2296","211.231.164.53","80","3","148","3","148","0","0","0.035032000","0.0015","788807.46","N/A"
"43.173.249.106","48249","189.129.142.66","80","1","56","1","56","0","0","0.035047000","0.0000","N/A","N/A"
"138.31.185.255","1322","58.57.200.97","443","1","918","1","918","0","0","0.035069000","0.0000","N/A","N/A"
"73.151.139.176","59678","58.57.179.200","80","3","3373","0","0","3","3373","0.035086000","0.0000","N/A","710105263.16"
"36.63.198.225","35704","232.30.102.15","80","10","560","10","560","0","0","0.035095000","0.0005","9593147.75","N/A"
"232.56.226.18","64592","58.57.179.230","80","1","56","0","0","1","56","0.035130000","0.0000","N/A","N/A"
"131.240.84.155","1100","232.60.178.118","443","1","1289","0","0","1","1289","0.035149000","0.0000","N/A","N/A"
"140.234.135.201","44832","211.248.0.25","80","1","56","1","56","0","0","0.035155000","0.0000","N/A","N/A"
"71.248.27.190","47742","191.235.251.124","80","1","46","1","46","0","0","0.035156000","0.0000","N/A","N/A"
"95.133.222.112","48529","29.22.12.198","80","1","56","1","56","0","0","0.035170000","0.0000","N/A","N/A"
"181.175.230.57","48775","199.174.53.50","80","1","479","1","479","0","0","0.035179000","0.0000","N/A","N/A"
"91.17.13.145","4454","211.231.171.101","80","2","112","2","112","0","0","0.035185000","0.0012","760611.21","N/A"
"74.116.200.79","22038","74.116.212.129","80","3","4512","0","0","3","4512","0.035193000","0.0000","N/A","6016000000.00"
"36.3.67.176","46844","74.110.251.203","80","1","56","1","56","0","0","0.035236000","0.0000","N/A","N/A"
"143.169.132.99","3793","192.220.255.160","445","1","52","1","52","0","0","0.035254000","0.0000","N/A","N/A"
"148.166.16.209","47321","153.231.133.204","25","2","76","0","0","1","76","0.035259000","0.0000","N/A","N/A"
"36.103.158.90","39713","92.52.238.166","80","1","46","1","46","0","0","0.035287000","0.0000","N/A","N/A"
"181.0.181.187","53111","181.175.235.132","80","10","12999","0","0","10","12999","0.035290000","0.0001","N/A","1386560000.00"
"142.84.244.21","2119","186.237.209.219","80","1","710","0","0","1","710","0.035294000","0.0000","N/A","N/A"
"28.34.225.77","61860","76.73.25.135","51413","1","46","0","0","1","46","0.035295000","0.0000","N/A","N/A"
"159.213.121.224","65017","232.60.179.214","80","1","1400","0","0","1","1400","0.035310000","0.0000","N/A","N/A"
"142.81.183.167","63950","232.60.178.252","80","2","2992","0","0","2","2992","0.035330000","0.0000","N/A","1709714285.71"
"142.85.213.100","24977","232.60.178.73","80","1","1444","0","0","1","1444","0.035346000","0.0000","N/A","N/A"
"131.240.20.143","10952","232.60.179.246","443","2","2888","0","0","2","2888","0.035352000","0.0000","N/A","1925333333.33"
"211.188.128.236","55794","75.179.10.117","80","3","1240","3","1240","0","0","0.035363000","0.0019","5339074.27","N/A"
"181.129.193.90","52314","179.233.124.26","443","2","92","0","0","2","92","0.035364000","0.0001","N/A","10366197.18"
"131.246.183.15","9914","232.60.179.232","443","2","2992","0","0","2","2992","0.035369000","0.0000","N/A","2176000000.00"
"49.114.143.22","10795","12.253.77.17","443","1","481","1","481","0","0","0.035378000","0.0000","N/A","N/A"
"34.161.82.111","10809","211.188.8.166","3004","1","50","0","0","1","50","0.035384000","0.0000","N/A","N/A"
"177.184.1.237","11185","36.225.33.213","443","1","56","1","56","0","0","0.035397000","0.0000","N/A","N/A"
"130.30.38.196","49984","211.231.170.42","80","1","46","1","46","0","0","0.035403000","0.0000","N/A","N/A"
"135.139.21.18","64986","211.200.228.231","80","1","46","1","46","0","0","0.035413000","0.0000","N/A","N/A"
"141.145.147.90","44244","232.60.179.223","80","9","13356","0","0","9","13356","0.035422000","0.0001","N/A","1079272727.27"
"71.126.31.143","43642","181.175.235.132","80","1","56","0","0","1","56","0.035426000","0.0000","N/A","N/A"
"140.216.98.106","50939","211.231.171.234","8080","1","46","1","46","0","0","0.035449000","0.0000","N/A","N/A"
"0.140.137.226","60962","73.228.141.111","80","3","4512","0","0","3","4512","0.035520000","0.0000","N/A","1203200000.00"
"49.114.244.51","64111","29.22.12.247","443","1","56","1","56","0","0","0.035574000","0.0000","N/A","N/A"
"95.148.163.97","60110","70.7.191.81","80","2","92","2","92","0","0","0.035582000","0.0000","N/A","N/A"
"140.205.190.151","62047","211.231.171.101","80","2","92","2","92","0","0","0.035592000","0.0012","607260.73","N/A"
"75.224.151.248","60208","181.175.235.133","80","1","56","0","0","1","56","0.035592000","0.0000","N/A","N/A"
"142.91.159.16","49381","232.60.178.254","443","2","2992","0","0","2","2992","0.035602000","0.0000","N/A","1709714285.71"
"142.85.188.125","13207","232.60.178.66","80","1","1444","0","0","1","1444","0.035604000","0.0000","N/A","N/A"
"142.89.126.133","4697","36.3.67.166","80","1","50","0","0","1","50","0.035624000","0.0000","N/A","N/A"
"39.109.242.124","22108","181.175.224.85","443","4","251","0","0","4","251","0.035624000","0.0001","N/A","29101449.28"
"137.243.51.31","49919","211.231.170.245","80","4","184","4","184","0","0","0.035642000","0.0013","1171042.16","N/A"
"223.224.51.246","49845","224.243.33.1","80","2","841","2","841","0","0","0.035673000","0.0004","17251282.05","N/A"
"16.37.22.161","16397","243.98.109.220","443","1","153","0","0","1","153","0.035687000","0.0000","N/A","N/A"
"36.3.67.140","37378","216.19.1.169","80","6","336","6","336","0","0","0.035693000","0.0001","39529411.76","N/A"
"133.255.41.223","23887","176.205.189.50","80","1","46","1","46","0","0","0.035733000","0.0000","N/A","N/A"
"143.145.92.161","62238","179.181.220.103","445","1","212","1","212","0","0","0.035770000","0.0000","N/A","N/A"
"77.212.197.107","59354","189.129.142.80","80","1","46","1","46","0","0","0.035797000","0.0000","N/A","N/A"
"71.215.84.71","38705","181.175.235.132","443","1","1504","0","0","1","1504","0.035811000","0.0000","N/A","N/A"
"146.24.150.207","52452","178.165.116.164","587","1","56","0","0","1","56","0.035838000","0.0000","N/A","N/A"
"181.131.202.70","61248","73.97.113.84","1935","6","7037","0","0","6","7037","0.035887000","0.0009","N/A","62274336.28"
"232.31.17.167","42031","74.110.251.26","80","1","1005","1","1005","0","0","0.035891000","0.0000","N/A","N/A"
"216.9.124.167","53819","29.22.12.214","80","1","904","1","904","0","0","0.035919000","0.0000","N/A","N/A"
"81.230.151.51","57000","133.86.139.101","5001","2","2229","0","0","2","2229","0.035926000","0.0000","N/A","17831999999.98"
"182.110.227.244","41424","232.60.179.220","443","1","68","0","0","1","68","0.035939000","0.0000","N/A","N/A"
"143.144.179.145","28663","36.225.104.117","8080","1","56","1","56","0","0","0.035948000","0.0000","N/A","N/A"
"43.24.136.159","60334","176.205.174.34","80","1","46","1","46","0","0","0.035962000","0.0000","N/A","N/A"
"77.140.197.32","58542","231.131.116.140","37096","1","46","1","46","0","0","0.035965000","0.0000","N/A","N/A"
"137.234.41.224","63894","211.231.170.130","80","6","336","6","336","0","0","0.036005000","0.0011","2475138.12","N/A"
"232.60.179.157","50587","71.215.84.89","80","1","56","1","56","0","0","0.036011000","0.0000","N/A","N/A"
"142.91.127.39","10936","36.3.67.226","443","1","1444","0","0","1","1444","0.036017000","0.0000","N/A","N/A"
"219.104.52.212","19923","176.205.174.34","80","1","46","1","46","0","0","0.036019000","0.0000","N/A","N/A"
"40.56.58.183","33488","71.85.125.212","80","1","68","1","68","0","0","0.036035000","0.0000","N/A","N/A"
"49.111.57.144","5085","73.151.139.180","443","1","46","1","46","0","0","0.036055000","0.0000","N/A","N/A"
"136.200.137.29","61286","36.225.51.124","80","2","92","2","92","0","0","0.036067000","0.0000","736000000.00","N/A"
"88.195.33.207","49337","36.3.67.180","443","1","1484","0","0","1","1484","0.036072000","0.0000","N/A","N/A"
"232.60.179.150","44879","71.126.28.187","80","3","168","3","168","0","0","0.036078000","0.0000","35368421.05","N/A"
"131.247.56.24","14978","232.60.179.160","443","2","2888","0","0","2","2888","0.036081000","0.0000","N/A","1777230769.23"
"141.148.169.21","15738","232.60.179.253","80","3","4332","0","0","3","4332","0.036086000","0.0000","N/A","1575272727.27"
"43.173.250.226","40844","159.183.78.181","80","2","388","2","388","0","0","0.036088000","0.0001","44342857.14","N/A"
"142.83.175.74","23663","232.60.179.145","443","4","5776","0","0","4","5776","0.036090000","0.0009","N/A","48640000.00"
"77.192.158.237","54693","177.54.91.78","8080","1","46","1","46","0","0","0.036105000","0.0000","N/A","N/A"
"142.91.199.181","18457","232.60.178.111","80","1","1444","0","0","1","1444","0.036115000","0.0000","N/A","N/A"
"77.157.49.106","37313","232.60.179.225","443","1","50","0","0","1","50","0.036137000","0.0000","N/A","N/A"
"232.60.178.114","64902","181.0.142.9","80","3","168","3","168","0","0","0.036148000","0.0002","5670886.08","N/A"
"191.121.72.97","65100","71.199.4.97","80","4","224","4","224","0","0","0.036162000","0.0001","25971014.49","N/A"
"140.222.68.158","41571","182.107.170.119","21447","3","168","3","168","0","0","0.036163000","0.0000","192000000.00","N/A"
"222.107.103.86","1191","211.231.164.53","80","1","46","1","46","0","0","0.036229000","0.0000","N/A","N/A"
"232.60.178.104","52870","74.110.251.26","80","1","56","1","56","0","0","0.036232000","0.0000","N/A","N/A"
"92.249.93.66","55562","181.175.230.104","80","1","46","0","0","1","46","0.036256000","0.0000","N/A","N/A"
"132.14.250.214","41751","81.245.238.175","80","1","64","1","64","0","0","0.036262000","0.0000","N/A","N/A"
"138.243.246.204","28951","159.183.68.245","80","1","56","1","56","0","0","0.036311000","0.0000","N/A","N/A"
"92.222.167.22","40887","191.250.205.245","8640","1","50","0","0","1","50","0.036352000","0.0000","N/A","N/A"
"191.235.250.209","33276","191.235.251.124","80","1","46","1","46","0","0","0.036353000","0.0000","N/A","N/A"
"88.158.214.75","1607","211.231.170.122","80","1","46","1","46","0","0","0.036382000","0.0000","N/A","N/A"
"0.205.98.49","60938","135.239.11.44","33318","1","46","0","0","1","46","0.036395000","0.0000","N/A","N/A"
"229.195.147.138","1975","36.225.199.184","80","1","52","1","52","0","0","0.036395000","0.0000","N/A","N/A"
"141.0.0.152","23728","92.30.175.26","8080","1","633","1","633","0","0","0.036455000","0.0000","N/A","N/A"
"36.3.67.174","45502","71.215.84.65","80","1","914","1","914","0","0","0.036462000","0.0000","N/A","N/A"
"142.81.202.88","27756","186.237.209.223","80","1","339","0","0","1","339","0.036463000","0.0000","N/A","N/A"
"211.188.158.133","38743","75.179.10.102","443","1","381","1","381","0","0","0.036490000","0.0000","N/A","N/A"
"181.0.142.14","43799","181.175.233.22","80","10","13314","0","0","10","13314","0.036503000","0.0001","N/A","1936581818.18"
"142.85.213.203","23442","232.60.177.211","443","1","50","0","0","1","50","0.036505000","0.0000","N/A","N/A"
"8.113.75.79","54321","232.0.220.96","1837","1","52","0","0","1","52","0.036507000","0.0000","N/A","N/A"
"74.110.251.199","52456","181.175.235.133","80","1","56","0","0","1","56","0.036507000","0.0000","N/A","N/A"
"232.31.17.1","63413","29.22.12.244","80","1","1068","1","1068","0","0","0.036511000","0.0000","N/A","N/A"
"129.30.50.43","53589","211.231.164.53","80","6","336","6","336","0","0","0.036553000","0.0006","4587030.72","N/A"
"131.19.184.147","64780","73.235.235.194","10569","2","100","2","100","0","0","0.036567000","0.0006","1426024.96","N/A"
"141.144.78.52","52488","232.60.179.225","443","1","50","0","0","1","50","0.036600000","0.0000","N/A","N/A"
"141.148.207.14","26095","232.60.179.168","80","2","2992","0","0","2","2992","0.036608000","0.0000","N/A","1408000000.00"
"132.244.220.62","45383","232.21.85.239","80","2","112","2","112","0","0","0.036620000","0.0000","64000000.00","N/A"
"71.147.197.214","56379","232.60.178.91","443","1","1504","0","0","1","1504","0.036640000","0.0000","N/A","N/A"
"215.75.173.58","48750","75.179.10.113","80","1","141","1","141","0","0","0.036659000","0.0000","N/A","N/A"
"95.165.55.226","65428","0.216.49.199","49917","1","46","1","46","0","0","0.036700000","0.0000","N/A","N/A"
"232.60.177.222","55331","71.85.160.57","80","1","56","1","56","0","0","0.036706000","0.0000","N/A","N/A"
"92.249.93.66","22120","181.175.230.104","80","1","50","0","0","1","50","0.036707000","0.0000","N/A","N/A"
"43.98.114.241","52768","176.205.174.33","80","2","92","2","92","0","0","0.036724000","0.0000","92000000.00","N/A"
"232.31.17.120","35248","75.224.151.238","80","1","809","1","809","0","0","0.036746000","0.0000","N/A","N/A"
"142.70.94.231","50428","232.60.179.146","443","2","2992","0","0","2","2992","0.036763000","0.0000","N/A","1994666666.67"
"232.60.179.190","60942","71.215.84.8","80","2","112","2","112","0","0","0.036794000","0.0003","3111111.11","N/A"
"94.244.191.224","50301","176.205.174.41","80","1","56","1","56","0","0","0.036819000","0.0000","N/A","N/A"
"151.233.223.13","40330","50.19.133.98","8080","1","56","1","56","0","0","0.036820000","0.0000","N/A","N/A"
"70.135.1.89","63165","181.175.237.236","443","2","127","0","0","2","127","0.036822000","0.0001","N/A","11043478.26"
"36.3.67.207","49664","74.110.251.247","80","1","56","1","56","0","0","0.036849000","0.0000","N/A","N/A"
"216.42.62.50","57484","71.85.125.15","80","2","112","2","112","0","0","0.036869000","0.0003","3343283.58","N/A"
"232.31.52.43","39865","71.85.124.104","80","1","56","1","56","0","0","0.036885000","0.0000","N/A","N/A"
"142.81.206.99","52305","232.60.178.110","443","1","50","0","0","1","50","0.036922000","0.0000","N/A","N/A"
"49.119.174.221","1254","73.151.139.181","443","2","92","2","92","0","0","0.036925000","0.0000","368000000.00","N/A"
"133.203.23.236","38861","29.22.12.214","80","1","56","1","56","0","0","0.036985000","0.0000","N/A","N/A"
"50.173.113.192","34420","132.112.183.130","80","1","56","0","0","1","56","0.036992000","0.0000","N/A","N/A"
"232.60.177.158","50285","75.226.168.88","80","1","56","1","56","0","0","0.036995000","0.0000","N/A","N/A"
"135.84.79.251","52799","211.231.171.101","80","1","56","1","56","0","0","0.036998000","0.0000","N/A","N/A"
"49.118.61.48","23616","58.57.248.101","80","1","68","1","68","0","0","0.037020000","0.0000","N/A","N/A"
"133.203.14.169","34769","75.179.35.253","80","3","138","3","138","0","0","0.037033000","0.0001","9769911.50","N/A"
"219.116.104.20","3768","50.19.250.170","80","1","46","1","46","0","0","0.037038000","0.0000","N/A","N/A"
"71.248.19.93","56055","73.168.182.201","80","1","50","0","0","1","50","0.037058000","0.0000","N/A","N/A"
"132.42.61.82","44455","36.3.137.106","443","1","701","1","701","0","0","0.037075000","0.0000","N/A","N/A"
"211.231.162.130","8080","140.254.35.122","5010","3","208","0","0","3","208","0.037089000","0.0000","N/A","72347826.09"
"70.135.1.88","54611","181.175.224.85","443","1","1363","0","0","1","1363","0.037132000","0.0000","N/A","N/A"
"71.85.125.157","39550","181.175.235.132","80","1","56","0","0","1","56","0.037135000","0.0000","N/A","N/A"
"136.200.193.2","57407","80.89.111.90","80","2","92","2","92","0","0","0.037152000","0.0001","10082191.78","N/A"
"70.135.1.99","36753","50.3.145.217","443","1","1208","0","0","1","1208","0.037158000","0.0000","N/A","N/A"
"137.88.243.45","51389","181.168.221.165","8080","3","138","3","138","0","0","0.037170000","0.0000","32470588.24","N/A"
"211.231.171.234","8080","49.68.52.57","2901","3","138","0","0","3","138","0.037200000","0.0000","N/A","N/A"
"36.233.66.27","55379","36.120.254.158","443","2","2025","2","2025","0","0","0.037210000","0.0000","16199999999.98","N/A"
"231.85.236.27","35516","64.34.19.219","2809","1","52","0","0","1","52","0.037225000","0.0000","N/A","N/A"
"232.60.178.248","62410","181.0.120.66","80","1","806","1","806","0","0","0.037227000","0.0000","N/A","N/A"
"132.245.204.191","38123","181.168.247.106","9117","1","56","1","56","0","0","0.037229000","0.0000","N/A","N/A"
"142.81.226.216","58870","232.60.177.151","443","3","3625","0","0","3","3625","0.037248000","0.0000","N/A","2230769230.77"
"0.140.29.253","61797","211.188.166.224","80","1","267","0","0","1","267","0.037264000","0.0000","N/A","N/A"
"229.123.87.111","61797","148.163.34.10","80","3","0","0","0","0","0","0","0.0000","N/A","N/A"
